Alignf=JvgAlignForm
Alignfnc=JvgAlignFunction
CheckVersionInfo=JvgCheckVersionInfo
CompDescription=JvgCompDescription
DrawTab=JvgDrawTab
FileIterator=JvgFileIterator
gcSysRequirements=JvgConstSysRequirements
geCList=JvgComponentListEditor
geHelpPanel=JvgHelpPanelEditor
geLogicItemEditor=JvgLogicItemEditor
geLogics=JvgLogicsEditor
geQPrintPreview=JvgQPrintPreview
geQPrintSetup=JvgQPrintSetup
geReport=JvgReportEditor
geRPEdit=JvgReportParamEditorForm
geRPForm=JvgReportParamEditor
geRTFPreview=JvgRTFPreviewEditor
geShadow=JvgShadowEditor
Gl3dcol=Jvg3DColors
glALBox=JvgAskListBox
glBevel=JvgBevel
glBitBtn=JvgBitBtn
Glbutton=JvgButton
Glcapt=JvgCaption
glCBox=JvgCheckBox
glCGI=JvgCGI
glCommCl=JvgCommClasses
Glctable=JvgCrossTable
GlDBGrid=JvgDBGrid
glDBNav=JvgDBNav
glDigits=JvgDigits
Gledit=JvgEdit
glExceptionHandler=JvgExceptionHandler
glExport=JvgExport
glExportComponents=JvgExportComponents
Glfixfnt=JvgFixFont
glFlyTxt=JvgFlyingText
glFUtils=JvgFileUtils
glGBtn=JvgGraphicButton
glGHC=JvgGridHeaderControl
Glgraph=JvgGraph
glGrBox=JvgGroupBox
glHelpPanel=JvgHelpPanel
glHint=JvgHint
glHShape=JvgHoleShape
glHTTPVersionInfo=JvgHTTPVersionInfo
glImage=JvgImage
Glimggr=JvgImageGroup
glInspectorGrid=JvgInspectorGrid
glJump=JvgJump
glLabel=JvgLabel
glLanguageLoader=JvgLanguageLoader
glLBox=JvgListBox
glLogics=JvgLogics
glMRes=JvgMultiResources
glMSlots=JvgMailSlots
glPage=JvgPage
glPrgrs=JvgProgress
glProcs=JvgProcess
glPropCn=JvgPropertyCenter
glReport=JvgReport
glRLabel=JvgQRLabel
glRttiUtils=JvgRttiUtils
glRuler=JvgRuler
glRUtils=JvgRichEditUtils
glSBox=JvgScrollBox
glSGrid=JvgStringGrid
Glshade=JvgShade
glShadow=JvgShadow
glShape=JvgShape
glSingleInstance=JvgSingleInstance
glSmallFontsDefence=JvgSmallFontsDefence
glSpeedButton=JvgSpeedButton
glSplit=JvgSplit
glStepLabel=JvgStepLabel
glStringContainer=JvgStringContainer
Glsttext=JvgStaticText
glSysInf=JvgSysInf
glSysRequirements=JvgSysRequirements
glTab=JvgTab
glTagParser=JvgTagParser
Gltrmemo=JvgTransparentMemo
glTView=JvgTreeView
gltypes=JvgTypes
glUtils=JvgUtils
Glvdbgrd=JvgVertDBGrid
glWinMask=JvgWinMask
glWizardHeader=JvgWizardHeader
glXMLSerializer=JvgXMLSerializer
mresed=JvgMultiResourceEditor
Pointedt=JvgPointEditor
Prcutils=JvgProcessUtils
reggllib_builder5=JvgRegLibCBB5
reggllib_delphi=JvgRegLibDelphi
reggllib_delphi3=JvgRegLibDelphi3
TabComm=JvgTabComm
WebDocumentIterator=JvgWebDocumentIterator
glExportException=EJvgExportException
EglHandlerException=EJvgHandlerException
T2DAlign=TJvg2DAlign
TThreeDGradient=TJvg3DGradient
TglAskListBox=TJvgAskListBox
TglAskListBoxItemStyle=TJvgAskListBoxItemStyle
TglBevel=TJvgBevel
TglBevelLines=TJvgBevelLines
TglBitBtn=TJvgBitBtn
TglBitmapImage=TJvgBitmapImage
TglBtnGlyphs=TJvgBtnGlyphs
TglButton=TJvgButton
TglCaption=TJvgCaption
TglCGI=TJvgCGI
TglCheckBox=TJvgCheckBox
TglCheckListBox=TJvgCheckListBox
TglCheckTreeView=TJvgCheckTreeView
TCommentArea=TJvgCommentArea
TCommentAreas=TJvgCommentAreas
TglCommonExport=TJvgCommonExport
TglCompListEditor=TJvgCompListEditor
TComponentDescription=TJvgComponentDescription
TglComponentListEditor=TJvgComponentListEditor
TglComponentListProperty=TJvgComponentListProperty
TglCustomBoxStyle=TJvgCustomBoxStyle
TCustomGradient=TJvgCustomGradient
TglCustomLabel=TJvgCustomLabel
TglCustomLabelColors=TJvgCustomLabelColors
TglCustomListBoxItemStyle=TJvgCustomListBoxItemStyle
TglCustomTextBoxStyle=TJvgCustomTextBoxStyle
TglCustomTextColors=TJvgCustomTextColors
TglCustomTreeView=TJvgCustomTreeView
TglCustomVertDBSGrid=TJvgCustomVertDBSGrid
TglDBGrid=TJvgDBGrid
TglDBNAvigator=TJvgDBNAvigator
TglDigits=TJvgDigits
TglExceptionHandler=TJvgExceptionHandler
TglExportDBETable=TJvgExportDBETable
TglExportExcel=TJvgExportExcel
TglExportHTML=TJvgExportHTML
TglExportXML=TJvgExportXML
TglExtBevel=TJvgExtBevel
TfCheckVersionInfo=TJvgfCheckVersionInfo
TFileIterator=TJvgFileIterator
TglFixFont=TJvgFixFont
TglFlyingText=TJvgFlyingText
TfPrintPreview=TJvgfPrintPreview
TglGlyphLabel=TJvgGlyphLabel
TGlyphsIndexes=TJvgGlyphsIndexes
TGradient=TJvgGradient
TglGraph=TJvgGraph
TglGraphicButton=TJvgGraphicButton
TglGridHeaderControl=TJvgGridHeaderControl
TglGridItem=TJvgGridItem
TglGridItems=TJvgGridItems
TglGroupBox=TJvgGroupBox
TglGrBoxColors=TJvgGroupBoxColors
TglGroupBoxPlus=TJvgGroupBoxPlus
TglHelpPanel=TJvgHelpPanel
TglHelpPanel_Editor=TJvgHelpPanelEditor
TglHint=TJvgHint
TglHintWindow=TJvgHintWindow
TglHoleShape=TJvgHoleShape
TglHTTPVersionInfo=TJvgHTTPVersionInfo
TIllumination=TJvgIllumination
TglImageGroup=TJvgImageGroup
TglInspectorGrid=TJvgInspectorGrid
TIterator=TJvgIterator
TglJumpingComponent=TJvgJumpingComponent
TglLabel=TJvgLabel
TglLabelColors=TJvgLabelColors
TglLabelTextStyles=TJvgLabelTextStyles
TglLanguageLoader=TJvgLanguageLoader
TglListBox=TJvgListBox
TglListBoxItemStyle=TJvgListBoxItemStyle
TLogicElement=TJvgLogicElement
TfLogicItemEditor=TJvgLogicItemEditor
TLogicProducer=TJvgLogicProducer
TLogics=TJvgLogics
TglLogicsComponentEditor=TJvgLogicsComponentEditor
TglLogicsEditor=TJvgLogicsEditor
TLogicVariant=TJvgLogicVariant
TLogicVariants=TJvgLogicVariants
TglMailSlotClient=TJvgMailSlotClient
TglMailSlotServer=TJvgMailSlotServer
TglMaskEdit=TJvgMaskEdit
TglMresEdit=TJvgMultipleResourceEdit
TglMultiResources=TJvgMultipleResources
TmyQRPreview=TJvgMyQRPreview
TglPageControl=TJvgPageControl
TPointClass=TJvgPointClass
TPointProperty=TJvgPointProperty
TglPrintCrossTable=TJvgPrintCrossTable
TglPrintCrossTableColors=TJvgPrintCrossTableColors
TglPrintCrossTableFonts=TJvgPrintCrossTableFonts
TglPrintCrossTableIndents=TJvgPrintCrossTableIndents
TfPrintSetup=TJvgPrintSetup
TglProcess=TJvgProcess
TglProgress=TJvgProgress
TglPropertyCenter=TJvgPropertyCenter
TPropInform=TJvgPropInform
TPropInfos=TJvgPropInfos
TPublicControl=TJvgPublicControl
TPublicControlClass=TJvgPublicControlClass
TPublicControlFont=TJvgPublicControlFont
TPublicGrid=TJvgPublicGrid
TPublicWinControl=TJvgPublicWinControl
TglQRDBText=TJvgQRDBText
TglQRLabel=TJvgQRLabel
TglRep_Editor=TJvgReportCompEditor
TglRepEditor=TJvgReportEditorForm
TglReport=TJvgReport
TglReportEditor=TJvgReportEditor
TglReportItem=TJvgReportItem
TReportParamEditor=TJvgReportParamEditor
TglReportParamsEditor=TJvgReportParamsEditor
TReportParamsForm=TJvgReportParamsForm
TglRepParams_Editor=TJvgRepParamsEditor
TglRep_Property=TJvgRepProperty
TlaScrollBox=TJvgRepScrollBox
TglResourcesProperty=TJvgResourcesProperty
TResStringList=TJvgResStringList
TfRTFPreview=TJvgRTFPreview
TglRuler=TJvgRuler
TglScrollBox=TJvgScrollBox
TglShade=TJvgShade
TglShadow=TJvgShadow
TglShadow_Editor=TJvgShadowEditor
TglShape=TJvgShape
TglShapePlus=TJvgShapePlus
TShowFont=TJvgShowFont
TglSimleLabelColors=TJvgSimleLabelColors
TglSingleInstance=TJvgSingleInstance
TglSmallFontsDefence=TJvgSmallFontsDefence
TglSpeedButton=TJvgSpeedButton
TglSplitter=TJvgSplitter
TglStaticText_=TJvgStaticText
TglStaticText=TJvgStaticTextLabel
TglStepLabel=TJvgStepLabel
TglStringContainer=TJvgStringContainer
TglStringGrid=TJvgStringGrid
TglSysInfo=TJvgSysInfo
TglSysRequirements=TJvgSysRequirements
TglTabControl=TJvgTabControl
TTabStyle=TJvgTabStyle
TTabsWallpaper=TJvgTabsWallpaper
TglTagParser=TJvgTagParser
TglTextBoxStyle=TJvgTextBoxStyle
TglTranspMemo=TJvgTranspMemo
TglTreeView=TJvgTreeView
TTwainColors=TJvgTwainColors
TglVertDBSGrid=TJvgVertDBSGrid
TWebDocumentIterator=TJvgWebDocumentIterator
TglWinMask=TJvgWinMask
TglWizardHeader=TJvgWizardHeader
TglXMLSerializer=TJvgXMLSerializer
XMLSerializerException=EJvgXMLSerializerException
{$I glDEF.INC}={$I JVCL.INC}
GLVER_D5}=COMPILER5_UP}
GLVER_D6}=COMPILER6_UP}
GLVER_D4}=COMPILER4_UP}
