bzip2                                   =bzip2
Cfg                                     =Cfg
CfgMgr32                                =CfgMgr32
DBT                                     =DBT
Hardlinks                               =Hardlinks
Hardlinks                               =Hardlinks
Hid                                     =Hid
HidToken                                =HidToken
HidUsage                                =HidUsage
Jcl8087                                 =Jcl8087
JclAbstractContainers                   =JclAbstractContainers
JclAlgorithms                           =JclAlgorithms
JclAlgorithms                           =JclAlgorithms
JclAnsiStrings                          =JclAnsiStrings
JclAppInst                              =JclAppInst
JclArrayLists                           =JclArrayLists
JclArrayLists                           =JclArrayLists
JclArraySets                            =JclArraySets
JclArraySets                            =JclArraySets
JclBase                                 =JclBase
JclBinaryTrees                          =JclBinaryTrees
JclBinaryTrees                          =JclBinaryTrees
JclCharsets                             =JclCharsets
JclCIL                                  =JclCIL
JclCLR                                  =JclCLR
JclCOM                                  =JclCOM
JclCompilerUtils                        =JclCompilerUtils
JclComplex                              =JclComplex
JclCompression                          =JclCompression
JclConsole                              =JclConsole
JclContainerIntf                        =JclContainerIntf
JclContainerIntf                        =JclContainerIntf
JclCounter                              =JclCounter
JclCppException                         =JclCppException
JclDateTime                             =JclDateTime
JclDebug                                =JclDebug
JclDebugSerialization                   =JclDebugSerialization
JclDebugXMLDeserializer                 =JclDebugXMLDeserializer
JclDebugXMLSerializer                   =JclDebugXMLSerializer
JclDevToolsResources                    =JclDevToolsResources
JclDotNet                               =JclDotNet
JclExprEval                             =JclExprEval
JclFileUtils                            =JclFileUtils
JclFont                                 =JclFont
JclGraphics                             =JclGraphics
JclGraphics                             =JclGraphics
JclGraphUtils                           =JclGraphUtils
JclGraphUtils                           =JclGraphUtils
JclHashMaps                             =JclHashMaps
JclHashMaps                             =JclHashMaps
JclHashSets                             =JclHashSets
JclHashSets                             =JclHashSets
JclHelpUtils                            =JclHelpUtils
JclHookExcept                           =JclHookExcept
JclIDEUtils                             =JclIDEUtils
JclIniFiles                             =JclIniFiles
JclLANMan                               =JclLANMan
JclLinkedLists                          =JclLinkedLists
JclLinkedLists                          =JclLinkedLists
JclLocales                              =JclLocales
JclLogic                                =JclLogic
JclMapi                                 =JclMapi
JclMath                                 =JclMath
JclMetadata                             =JclMetadata
JclMIDI                                 =JclMIDI
JclMime                                 =JclMime
JclMiscel                               =JclMiscel
JclMsBuild                              =JclMsBuild
JclMsdosSys                             =JclMsdosSys
JclMultimedia                           =JclMultimedia
JclNotify                               =JclNotify
JclNTFS                                 =JclNTFS
JclOpenDialogFavorites                  =JclOpenDialogFavorites
JclOpenDialogHooks                      =JclOpenDialogHooks
JclPCRE                                 =JclPCRE
JclPeImage                              =JclPeImage
JclPreProcessorAlgorithmsTemplates      =JclPreProcessorAlgorithmsTemplates
JclPreProcessorArrayListsTemplates      =JclPreProcessorArrayListsTemplates
JclPreProcessorArraySetsTemplates       =JclPreProcessorArraySetsTemplates
JclPreProcessorBinaryTreesTemplates     =JclPreProcessorBinaryTreesTemplates
JclPreProcessorContainer1DTemplates     =JclPreProcessorContainer1DTemplates
JclPreProcessorContainer2DTemplates     =JclPreProcessorContainer2DTemplates
JclPreProcessorContainerIntfTemplates   =JclPreProcessorContainerIntfTemplates
JclPreProcessorContainerKnownMaps       =JclPreProcessorContainerKnownMaps
JclPreProcessorContainerKnownTypes      =JclPreProcessorContainerKnownTypes
JclPreProcessorContainerTemplates       =JclPreProcessorContainerTemplates
JclPreProcessorContainerTypes           =JclPreProcessorContainerTypes
JclPreProcessorExcDlgTemplates          =JclPreProcessorExcDlgTemplates
JclPreProcessorHashMapsTemplates        =JclPreProcessorHashMapsTemplates
JclPreProcessorLexer                    =JclPreProcessorLexer
JclPreProcessorLinkedListsTemplates     =JclPreProcessorLinkedListsTemplates
JclPreProcessorParser                   =JclPreProcessorParser
JclPreProcessorQueuesTemplates          =JclPreProcessorQueuesTemplates
JclPreProcessorSortedMapsTemplates      =JclPreProcessorSortedMapsTemplates
JclPreProcessorStacksTemplates          =JclPreProcessorStacksTemplates
JclPreProcessorTemplates                =JclPreProcessorTemplates
JclPreProcessorTreesTemplates           =JclPreProcessorTreesTemplates
JclPreProcessorVectorsTemplates         =JclPreProcessorVectorsTemplates
JclPrint                                =JclPrint
JclQueues                               =JclQueues
JclQueues                               =JclQueues
JclRegistry                             =JclRegistry
JclResources                            =JclResources
JclRTTI                                 =JclRTTI
JclSchedule                             =JclSchedule
JclSecurity                             =JclSecurity
JclShell                                =JclShell
JclSimpleXml                            =JclSimpleXml
JclSortedMaps                           =JclSortedMaps
JclSortedMaps                           =JclSortedMaps
JclStacks                               =JclStacks
JclStacks                               =JclStacks
JclStatistics                           =JclStatistics
JclStreams                              =JclStreams
JclStrHashMap                           =JclStrHashMap
JclStringConversions                    =JclStringConversions
JclStringLists                          =JclStringLists
JclStrings                              =JclStrings
JclStructStorage                        =JclStructStorage
JclSvcCtrl                              =JclSvcCtrl
JclSynch                                =JclSynch
JclSysInfo                              =JclSysInfo
JclSysUtils                             =JclSysUtils
JclTask                                 =JclTask
JclTD32                                 =JclTD32
JclTimeZones                            =JclTimeZones
JclTrees                                =JclTrees
JclTrees                                =JclTrees
JclUnicode                              =JclUnicode
JclUnitConv                             =JclUnitConv
JclUnitVersioning                       =JclUnitVersioning
JclUnitVersioningProviders              =JclUnitVersioningProviders
JclUsesUtils                            =JclUsesUtils
JclValidation                           =JclValidation
JclVclResources                         =JclVclResources
JclVectors                              =JclVectors
JclVectors                              =JclVectors
JclVersionControl                       =JclVersionControl
JclVersionCtrlCVSImpl                   =JclVersionCtrlCVSImpl
JclVersionCtrlGITImpl                   =JclVersionCtrlGITImpl
JclVersionCtrlSVNImpl                   =JclVersionCtrlSVNImpl
JclWideStrings                          =JclWideStrings
JclWin32                                =JclWin32
JclWin32                                =JclWin32
JclWin32Ex                              =JclWin32Ex
JclWinMIDI                              =JclWinMIDI
JvActions                               =JvActions
JvActionsEngine                         =JvActionsEngine
JvAddPrinter                            =JvAddPrinter
JvADOQuery                              =JvADOQuery
JvAirBrush                              =JvAirBrush
JvAlarms                                =JvAlarms
JvAni                                   =JvAni
JvAnimate                               =JvAnimate
JvAnimatedImage                         =JvAnimatedImage
JvAnimTitle                             =JvAnimTitle
JvAppAnimatedIcon                       =JvAppAnimatedIcon
JvAppCommand                            =JvAppCommand
JvAppDBStorage                          =JvAppDBStorage
JvAppEvent                              =JvAppEvent
JvAppHotKey                             =JvAppHotKey
JvAppIniStorage                         =JvAppIniStorage
JvAppInst                               =JvAppInst
JvAppRegistryStorage                    =JvAppRegistryStorage
JvAppStorage                            =JvAppStorage
JvAppStoragePropertyEngineDB            =JvAppStoragePropertyEngineDB
JvAppStorageSelectList                  =JvAppStorageSelectList
JvAppXMLStorage                         =JvAppXMLStorage
JvArrayButton                           =JvArrayButton
JvArrowButton                           =JvArrowButton
JvaScrollText                           =JvaScrollText
JvAutoComplete                          =JvAutoComplete
JvAVICapture                            =JvAVICapture
JvBackgrounds                           =JvBackgrounds
JvBalloonHint                           =JvBalloonHint
JvBandForms                             =JvBandForms
JvBandObject                            =JvBandObject
JvBaseDBDialog                          =JvBaseDBDialog
JvBaseDBLogonDialog                     =JvBaseDBLogonDialog
JvBaseDBPasswordDialog                  =JvBaseDBPasswordDialog
JvBaseDBThreadedDataset                 =JvBaseDBThreadedDataset
JvBaseDlg                               =JvBaseDlg
JvBaseEdits                             =JvBaseEdits
JvBaseThumbnail                         =JvBaseThumbnail
JvBDECheckPasswordForm                  =JvBDECheckPasswordForm
JvBDEExceptionForm                      =JvBDEExceptionForm
JvBDEFilter                             =JvBDEFilter
JvBDEIndex                              =JvBDEIndex
JvBDELists                              =JvBDELists
JvBDELoginDialog                        =JvBDELoginDialog
JvBDEMemTable                           =JvBDEMemTable
JvBDEMove                               =JvBDEMove
JvBDEProgress                           =JvBDEProgress
JvBDEQBE                                =JvBDEQBE
JvBDEQuery                              =JvBDEQuery
JvBDESecurity                           =JvBDESecurity
JvBDESQLScript                          =JvBDESQLScript
JvBdeUtils                              =JvBdeUtils
JvBehaviorLabel                         =JvBehaviorLabel
JvBevel                                 =JvBevel
JvBitBtn                                =JvBitBtn
JvBitmapButton                          =JvBitmapButton
JvBmpAnimator                           =JvBmpAnimator
JvBoxProcs                              =JvBoxProcs
JvBrowseFolder                          =JvBrowseFolder
JvButton                                =JvButton
JvButtonPersistent                      =JvButtonPersistent
JvButtons                               =JvButtons
JvCabFile                               =JvCabFile
JvCalc                                  =JvCalc
JvCalendar                              =JvCalendar
JvCaptionButton                         =JvCaptionButton
JvCaptionPanel                          =JvCaptionPanel
JvCaret                                 =JvCaret
JvChangeNotify                          =JvChangeNotify
JvCharMap                               =JvCharMap
JvChart                                 =JvChart
JvCheckBox                              =JvCheckBox
JvCheckedMaskEdit                       =JvCheckedMaskEdit
JvCheckListBox                          =JvCheckListBox
JvCheckTreeView                         =JvCheckTreeView
JvCipher                                =JvCipher
JvClipboardMonitor                      =JvClipboardMonitor
JvClipboardViewer                       =JvClipboardViewer
JvClipbrd                               =JvClipbrd
JvClock                                 =JvClock
JVCLVer                                 =JVCLVer
JvColorBox                              =JvColorBox
JvColorButton                           =JvColorButton
JvColorCombo                            =JvColorCombo
JvColorForm                             =JvColorForm
JvColorProvider                         =JvColorProvider
JvColorTrackbar                         =JvColorTrackbar
JvCombobox                              =JvCombobox
JvComboListBox                          =JvComboListBox
JvComCtrls                              =JvComCtrls
JvCommonDialogD                         =JvCommonDialogD
JvCommonExecDlg                         =JvCommonExecDlg
JvCommStatus                            =JvCommStatus
JvComponent                             =JvComponent
JvComponentBase                         =JvComponentBase
JvComponentPanel                        =JvComponentPanel
JvComputerInfoEx                        =JvComputerInfoEx
JvConnectNetwork                        =JvConnectNetwork
JvConsts                                =JvConsts
JvContentScroller                       =JvContentScroller
JvContextProvider                       =JvContextProvider
JvControlActions                        =JvControlActions
JvControlActionsEngine                  =JvControlActionsEngine
JvControlActionsEngineCxEditors         =JvControlActionsEngineCxEditors
JvControlActionsEngineCxGrid            =JvControlActionsEngineCxGrid
JvControlActionsEngineCxPivotGrid       =JvControlActionsEngineCxPivotGrid
JvControlActionsEngineCxTreeList        =JvControlActionsEngineCxTreeList
JvControlActionsEngineCxVerticalGrid    =JvControlActionsEngineCxVerticalGrid
JvControlActionsEngineDBGrid            =JvControlActionsEngineDBGrid
JvControlActionsEngineStringGrid        =JvControlActionsEngineStringGrid
JvControlActionsEngineTreeView          =JvControlActionsEngineTreeView
JvControlBar                            =JvControlBar
JvControlComponent                      =JvControlComponent
JvControlPanelButton                    =JvControlPanelButton
JvConverter                             =JvConverter
JvCoolBar                               =JvCoolBar
JvCopyError                             =JvCopyError
JvCpuUsage                              =JvCpuUsage
JvCreateProcess                         =JvCreateProcess
JvCSVBaseControls                       =JvCSVBaseControls
JvCsvData                               =JvCsvData
JvCsvParse                              =JvCsvParse
JvCtrls                                 =JvCtrls
JvCursor                                =JvCursor
JvCustomItemViewer                      =JvCustomItemViewer
JvDataEmbedded                          =JvDataEmbedded
JvDataProvider                          =JvDataProvider
JvDataProviderIntf                      =JvDataProviderIntf
JvDataSource                            =JvDataSource
JvDataSourceIntf                        =JvDataSourceIntf
JvDatePickerEdit                        =JvDatePickerEdit
JvDateTimePicker                        =JvDateTimePicker
JvDBActions                             =JvDBActions
JvDBActionsEngine                       =JvDBActionsEngine
JvDBActionsEngineControlCxGrid          =JvDBActionsEngineControlCxGrid
JvDBActionsEngineControlCxPivotGrid     =JvDBActionsEngineControlCxPivotGrid
JvDBActionsEngineControlCxTreeList      =JvDBActionsEngineControlCxTreeList
JvDBActionsEngineDatasetAdo             =JvDBActionsEngineDatasetAdo
JvDBActionsEngineDatasetCSVDataset      =JvDBActionsEngineDatasetCSVDataset
JvDBActionsEngineDatasetDBExpress       =JvDBActionsEngineDatasetDBExpress
JvDBActionsEngineDatasetDoa             =JvDBActionsEngineDatasetDoa
JvDBActionsEngineDatasetOdac            =JvDBActionsEngineDatasetOdac
JvDBCheckBox                            =JvDBCheckBox
JvDBCombobox                            =JvDBCombobox
JvDBControls                            =JvDBControls
JvDBDatePickerEdit                      =JvDBDatePickerEdit
JvDBDateTimePicker                      =JvDBDateTimePicker
JvDBDotNetControls                      =JvDBDotNetControls
JvDBFilterExpr                          =JvDBFilterExpr
JvDBFindEdit                            =JvDBFindEdit
JvDBGrid                                =JvDBGrid
JvDBGridExport                          =JvDBGridExport
JvDBGridFooter                          =JvDBGridFooter
JvDBGridSelectColumnForm                =JvDBGridSelectColumnForm
JvDBHTLabel                             =JvDBHTLabel
JvDBImage                               =JvDBImage
JvDBLogonDialogDoa                      =JvDBLogonDialogDoa
JvDBLogonDialogOdac                     =JvDBLogonDialogOdac
JvDBLookup                              =JvDBLookup
JvDBLookupComboEdit                     =JvDBLookupComboEdit
JvDBLookupTreeView                      =JvDBLookupTreeView
JvDBPasswordDialogDoa                   =JvDBPasswordDialogDoa
JvDBPasswordDialogOdac                  =JvDBPasswordDialogOdac
JvDBProgressBar                         =JvDBProgressBar
JvDBQueryParamsForm                     =JvDBQueryParamsForm
JvDBRadioPanel                          =JvDBRadioPanel
JvDBRemoteLogin                         =JvDBRemoteLogin
JvDBRichEdit                            =JvDBRichEdit
JvDBSearchComboBox                      =JvDBSearchComboBox
JvDBSearchEdit                          =JvDBSearchEdit
JvDBSpinEdit                            =JvDBSpinEdit
JvDBTreeView                            =JvDBTreeView
JvDBUltimGrid                           =JvDBUltimGrid
JvDBUtils                               =JvDBUtils
JvDdeCmd                                =JvDdeCmd
JvDebugHandler                          =JvDebugHandler
JvDeleteError                           =JvDeleteError
JvDesignClip                            =JvDesignClip
JvDesignImp                             =JvDesignImp
JvDesignSurface                         =JvDesignSurface
JvDesignUtils                           =JvDesignUtils
JvDesktopAlert                          =JvDesktopAlert
JvDesktopAlertForm                      =JvDesktopAlertForm
JvDiagramShape                          =JvDiagramShape
JvDialButton                            =JvDialButton
JvDialogActns                           =JvDialogActns
JvDialogs                               =JvDialogs
JvDice                                  =JvDice
JvDiskPrompt                            =JvDiskPrompt
JvDockAdvTree                           =JvDockAdvTree
JvDockControlForm                       =JvDockControlForm
JvDockDelphiStyle                       =JvDockDelphiStyle
JvDockGlobals                           =JvDockGlobals
JvDockHashTable                         =JvDockHashTable
JvDockInfo                              =JvDockInfo
JvDockSupportClass                      =JvDockSupportClass
JvDockSupportControl                    =JvDockSupportControl
JvDockSupportProc                       =JvDockSupportProc
JvDockTree                              =JvDockTree
JvDockVCStyle                           =JvDockVCStyle
JvDockVIDStyle                          =JvDockVIDStyle
JvDockVIDVCStyle                        =JvDockVIDVCStyle
JvDockVSNetStyle                        =JvDockVSNetStyle
JvDotNetControls                        =JvDotNetControls
JvDotNetUtils                           =JvDotNetUtils
JvDragDrop                              =JvDragDrop
JvDrawImage                             =JvDrawImage
JvDriveCtrls                            =JvDriveCtrls
JvDropDownForm                          =JvDropDownForm
JvDSADialogs                            =JvDSADialogs
JvDsgnIntf                              =JvDsgnIntf
JvDualList                              =JvDualList
JvDualListForm                          =JvDualListForm
JvDynControlEngine                      =JvDynControlEngine
JvDynControlEngineDB                    =JvDynControlEngineDB
JvDynControlEngineDBIntf                =JvDynControlEngineDBIntf
JvDynControlEngineDBTools               =JvDynControlEngineDBTools
JvDynControlEngineDBToolscxVGrid        =JvDynControlEngineDBToolscxVGrid
JvDynControlEngineDevExpCx              =JvDynControlEngineDevExpCx
JvDynControlEngineDevExpCxDB            =JvDynControlEngineDevExpCxDB
JvDynControlEngineIntf                  =JvDynControlEngineIntf
JvDynControlEngineJVCL                  =JvDynControlEngineJVCL
JvDynControlEngineJVCLDB                =JvDynControlEngineJVCLDB
JvDynControlEngineJVCLInspector         =JvDynControlEngineJVCLInspector
JvDynControlEngineTools                 =JvDynControlEngineTools
JvDynControlEngineVCL                   =JvDynControlEngineVCL
JvDynControlEngineVCLDB                 =JvDynControlEngineVCLDB
JvEasterEgg                             =JvEasterEgg
JvEdit                                  =JvEdit
JvEditor                                =JvEditor
JvEditorCommon                          =JvEditorCommon
JvEmbeddedForms                         =JvEmbeddedForms
JvEnterTab                              =JvEnterTab
JvErrorIndicator                        =JvErrorIndicator
JvExButtons                             =JvExButtons
JvExceptionForm                         =JvExceptionForm
JvExCheckLst                            =JvExCheckLst
JvExComCtrls                            =JvExComCtrls
JvExControls                            =JvExControls
JvExDBGrids                             =JvExDBGrids
JvExExtCtrls                            =JvExExtCtrls
JvExForms                               =JvExForms
JvExGrids                               =JvExGrids
JvExMask                                =JvExMask
JvExplorerBar                           =JvExplorerBar
JvExplorerBarItems                      =JvExplorerBarItems
JvExprParser                            =JvExprParser
JvExStdCtrls                            =JvExStdCtrls
JvExtComponent                          =JvExtComponent
JvFavoritesButton                       =JvFavoritesButton
JvFindFiles                             =JvFindFiles
JvFindReplace                           =JvFindReplace
JvFixedEditPopUp                        =JvFixedEditPopUp
JvFooter                                =JvFooter
JvFormAnimatedIcon                      =JvFormAnimatedIcon
JvFormAnimation                         =JvFormAnimation
JvFormAutoSize                          =JvFormAutoSize
JvFormMagnet                            =JvFormMagnet
JvFormPlacement                         =JvFormPlacement
JvFormPlacementSelectList               =JvFormPlacementSelectList
JvFormToHtml                            =JvFormToHtml
JvFormTransparent                       =JvFormTransparent
JvFormWallpaper                         =JvFormWallpaper
JvForth                                 =JvForth
JvFullColorCircleForm                   =JvFullColorCircleForm
JvFullColorCtrls                        =JvFullColorCtrls
JvFullColorDialogs                      =JvFullColorDialogs
JvFullColorForm                         =JvFullColorForm
JvFullColorRotate                       =JvFullColorRotate
JvFullColorSpaces                       =JvFullColorSpaces
Jvg3DColors                             =Jvg3DColors
JvgAlignFunction                        =JvgAlignFunction
JvGammaPanel                            =JvGammaPanel
JvgAskListBox                           =JvgAskListBox
JvgButton                               =JvgButton
JvgCaption                              =JvgCaption
JvgCheckBox                             =JvgCheckBox
JvgCommClasses                          =JvgCommClasses
JvgCrossTable                           =JvgCrossTable
JvgDigits                               =JvgDigits
JvgDrawTab                              =JvgDrawTab
JvGenetic                               =JvGenetic
JvgExport                               =JvgExport
JvgExportComponents                     =JvgExportComponents
JvgFileIterator                         =JvgFileIterator
JvgGraph                                =JvgGraph
JvgGroupBox                             =JvgGroupBox
JvgHint                                 =JvgHint
JvgHoleShape                            =JvgHoleShape
JvgHTTPVersionInfo                      =JvgHTTPVersionInfo
JvGIF                                   =JvGIF
JvGIFCtrl                               =JvGIFCtrl
JvgImage                                =JvgImage
JvgImageGroup                           =JvgImageGroup
JvgLabel                                =JvgLabel
JvgListBox                              =JvgListBox
JvgLogics                               =JvgLogics
JvGnugettext                            =JvGnugettext
JvgPage                                 =JvgPage
JvgProgress                             =JvgProgress
JvgQPrintPreviewForm                    =JvgQPrintPreviewForm
JvgQPrintSetupForm                      =JvgQPrintSetupForm
JvgQRLabel                              =JvgQRLabel
JvGradient                              =JvGradient
JvGradientCaption                       =JvGradientCaption
JvGradientHeaderPanel                   =JvGradientHeaderPanel
JvgReport                               =JvgReport
JvgReportParamsEditor                   =JvgReportParamsEditor
JvGridFilter                            =JvGridFilter
JvGridPreviewForm                       =JvGridPreviewForm
JvGridPrinter                           =JvGridPrinter
JvGrids                                 =JvGrids
JvGroupBox                              =JvGroupBox
JvGroupHeader                           =JvGroupHeader
JvgShade                                =JvgShade
JvgShadow                               =JvgShadow
JvgSpeedButton                          =JvgSpeedButton
JvgStringGrid                           =JvgStringGrid
JvgTab                                  =JvgTab
JvgTabComm                              =JvgTabComm
JvgTypes                                =JvgTypes
JvgUtils                                =JvgUtils
JvgWebDocumentIterator                  =JvgWebDocumentIterator
JvgXMLSerializer                        =JvgXMLSerializer
JvHeaderControl                         =JvHeaderControl
JvHidControllerClass                    =JvHidControllerClass
JvHint                                  =JvHint
JvHints                                 =JvHints
JvHLEditor                              =JvHLEditor
JvHLEditorPropertyForm                  =JvHLEditorPropertyForm
JvHLParser                              =JvHLParser
JvHotKey                                =JvHotKey
JvHotTrackPersistent                    =JvHotTrackPersistent
JvHtControls                            =JvHtControls
JvHtmlParser                            =JvHtmlParser
JvIconList                              =JvIconList
JvId3v1                                 =JvId3v1
JvId3v2                                 =JvId3v2
JvID3v2Base                             =JvID3v2Base
JvId3v2Types                            =JvId3v2Types
JvImage                                 =JvImage
JvImageDlg                              =JvImageDlg
JvImageDrawThread                       =JvImageDrawThread
JvImageList                             =JvImageList
JvImageListViewer                       =JvImageListViewer
JvImageRotate                           =JvImageRotate
JvImageSquare                           =JvImageSquare
JvImagesViewer                          =JvImagesViewer
JvImageTransform                        =JvImageTransform
JvInspDB                                =JvInspDB
JvInspector                             =JvInspector
JvInspExtraEditors                      =JvInspExtraEditors
JvInspXVCL                              =JvInspXVCL
JvInstallLabel                          =JvInstallLabel
JvInterpreter                           =JvInterpreter
JvInterpreter_all                       =JvInterpreter_all
JvInterpreter_Buttons                   =JvInterpreter_Buttons
JvInterpreter_Classes                   =JvInterpreter_Classes
JvInterpreter_ComCtrls                  =JvInterpreter_ComCtrls
JvInterpreter_Contnrs                   =JvInterpreter_Contnrs
JvInterpreter_Controls                  =JvInterpreter_Controls
JvInterpreter_Db                        =JvInterpreter_Db
JvInterpreter_DbCtrls                   =JvInterpreter_DbCtrls
JvInterpreter_DbGrids                   =JvInterpreter_DbGrids
JvInterpreter_DBTables                  =JvInterpreter_DBTables
JvInterpreter_Dialogs                   =JvInterpreter_Dialogs
JvInterpreter_ExtCtrls                  =JvInterpreter_ExtCtrls
JvInterpreter_Forms                     =JvInterpreter_Forms
JvInterpreter_Graphics                  =JvInterpreter_Graphics
JvInterpreter_Grids                     =JvInterpreter_Grids
JvInterpreter_httpapp                   =JvInterpreter_httpapp
JvInterpreter_JvEditor                  =JvInterpreter_JvEditor
JvInterpreter_JvInterpreter             =JvInterpreter_JvInterpreter
JvInterpreter_JvUtils                   =JvInterpreter_JvUtils
JvInterpreter_Math                      =JvInterpreter_Math
JvInterpreter_Menus                     =JvInterpreter_Menus
JvInterpreter_Quickrpt                  =JvInterpreter_Quickrpt
JvInterpreter_StdCtrls                  =JvInterpreter_StdCtrls
JvInterpreter_System                    =JvInterpreter_System
JvInterpreter_SysUtils                  =JvInterpreter_SysUtils
JvInterpreter_Types                     =JvInterpreter_Types
JvInterpreter_Windows                   =JvInterpreter_Windows
JvInterpreterConst                      =JvInterpreterConst
JvInterpreterFm                         =JvInterpreterFm
JvInterpreterParser                     =JvInterpreterParser
JvItemsPanel                            =JvItemsPanel
JvItemsSearchs                          =JvItemsSearchs
JvJanTreeView                           =JvJanTreeView
JvJclUnitVersioningBrowser              =JvJclUnitVersioningBrowser
JvJCLUtils                              =JvJCLUtils
JvJoystick                              =JvJoystick
JvJVCLAboutForm                         =JvJVCLAboutForm
JvJVCLUtils                             =JvJVCLUtils
JvLabel                                 =JvLabel
JvLED                                   =JvLED
JvLinkedControls                        =JvLinkedControls
JvLinkLabel                             =JvLinkLabel
JvLinkLabelDebug                        =JvLinkLabelDebug
JvLinkLabelParser                       =JvLinkLabelParser
JvLinkLabelRenderer                     =JvLinkLabelRenderer
JvLinkLabelTextHandler                  =JvLinkLabelTextHandler
JvLinkLabelTools                        =JvLinkLabelTools
JvLinkLabelTree                         =JvLinkLabelTree
JvListBox                               =JvListBox
JvListComb                              =JvListComb
JvListView                              =JvListView
JvLogClasses                            =JvLogClasses
JvLogFile                               =JvLogFile
JvLogForm                               =JvLogForm
JvLoginForm                             =JvLoginForm
JvLookOut                               =JvLookOut
JvMail                                  =JvMail
JvMailSlots                             =JvMailSlots
JvMarkupCommon                          =JvMarkupCommon
JvMarkupLabel                           =JvMarkupLabel
JvMarkupViewer                          =JvMarkupViewer
JvMaskEdit                              =JvMaskEdit
JvMaxPixel                              =JvMaxPixel
JvMemo                                  =JvMemo
JvMemoryDataset                         =JvMemoryDataset
JvMenus                                 =JvMenus
JvMergeManager                          =JvMergeManager
JvMessageControl                        =JvMessageControl
JvMonthCalendar                         =JvMonthCalendar
JvMouseGesture                          =JvMouseGesture
JvMouseTimer                            =JvMouseTimer
JvMovableBevel                          =JvMovableBevel
JvMRUList                               =JvMRUList
JvMRUManager                            =JvMRUManager
JvMTComponents                          =JvMTComponents
JvMTConsts                              =JvMTConsts
JvMTData                                =JvMTData
JvMTSync                                =JvMTSync
JvMTSyncMon                             =JvMTSyncMon
JvMTThreading                           =JvMTThreading
JvNavigationPane                        =JvNavigationPane
JvNetscapeSplitter                      =JvNetscapeSplitter
JvNTEventLog                            =JvNTEventLog
JvObjectPickerDialog                    =JvObjectPickerDialog
JvOdacSmartQuery                        =JvOdacSmartQuery
JvOfficeColorButton                     =JvOfficeColorButton
JvOfficeColorForm                       =JvOfficeColorForm
JvOfficeColorPanel                      =JvOfficeColorPanel
JvOfficeDragBarForm                     =JvOfficeDragBarForm
JvOracleDataSet                         =JvOracleDataSet
JvOutlookBar                            =JvOutlookBar
JvOwnerDrawViewer                       =JvOwnerDrawViewer
JvPageList                              =JvPageList
JvPageListTreeView                      =JvPageListTreeView
JvPageManager                           =JvPageManager
JvPageScroller                          =JvPageScroller
JvPageSetup                             =JvPageSetup
JvPageSetupTitled                       =JvPageSetupTitled
JvPainterEffectsForm                    =JvPainterEffectsForm
JvPainterQBForm                         =JvPainterQBForm
JvPaintFX                               =JvPaintFX
JvPanel                                 =JvPanel
JvParameterList                         =JvParameterList
JvParameterListParameter                =JvParameterListParameter
JvParameterListTools                    =JvParameterListTools
JvParserForm                            =JvParserForm
JvPatchFile                             =JvPatchFile
JvPatchForm                             =JvPatchForm
JvPcx                                   =JvPcx
JvPerfMon95                             =JvPerfMon95
JvPicClip                               =JvPicClip
JvPickDate                              =JvPickDate
JvPlaylist                              =JvPlaylist
JvPlugin                                =JvPlugin
JvPluginManager                         =JvPluginManager
JvPoweredBy                             =JvPoweredBy
JvPrint                                 =JvPrint
JvProfilerForm                          =JvProfilerForm
JvProgramVersionCheck                   =JvProgramVersionCheck
JvProgressBar                           =JvProgressBar
JvProgressComponent                     =JvProgressComponent
JvProgressDialog                        =JvProgressDialog
JvProgressForm                          =JvProgressForm
JvProgressUtils                         =JvProgressUtils
JvPropertyStorage                       =JvPropertyStorage
JvPropertyStore                         =JvPropertyStore
JvPropertyStoreEditor                   =JvPropertyStoreEditor
JvPropertyStoreEditorIntf               =JvPropertyStoreEditorIntf
JvPrvwDoc                               =JvPrvwDoc
JvPrvwRender                            =JvPrvwRender
JvQuickPreviewForm                      =JvQuickPreviewForm
JvRadioButton                           =JvRadioButton
JvRadioGroup                            =JvRadioGroup
JvRas32                                 =JvRas32
JvRecentMenuButton                      =JvRecentMenuButton
JvRegistryTreeview                      =JvRegistryTreeview
JvRenameError                           =JvRenameError
JvResample                              =JvResample
JvResources                             =JvResources
JvRgbToHtml                             =JvRgbToHtml
JvRichEdit                              =JvRichEdit
JvRichEditToHtml                        =JvRichEditToHtml
JvRollOut                               =JvRollOut
JvRuler                                 =JvRuler
JvSAL                                   =JvSAL
JvSALCore                               =JvSALCore
JvSALHashList                           =JvSALHashList
JvSALMath                               =JvSALMath
JvSchedEvtStore                         =JvSchedEvtStore
JvScheduledEvents                       =JvScheduledEvents
JvScreenResolution                      =JvScreenResolution
JvScreenSaver                           =JvScreenSaver
JvScreenSaveSuppress                    =JvScreenSaveSuppress
JvScrollBar                             =JvScrollBar
JvScrollBox                             =JvScrollBox
JvScrollMax                             =JvScrollMax
JvScrollPanel                           =JvScrollPanel
JvScrollText                            =JvScrollText
JvSearchFiles                           =JvSearchFiles
JvSecretPanel                           =JvSecretPanel
JvSegmentedLEDDisplay                   =JvSegmentedLEDDisplay
JvSegmentedLEDDisplayMapperFrame        =JvSegmentedLEDDisplayMapperFrame
JvSelectDirectory                       =JvSelectDirectory
JvSerialMaker                           =JvSerialMaker
JvShape                                 =JvShape
JvShapedButton                          =JvShapedButton
JvShellHook                             =JvShellHook
JvSHFileOperation                       =JvSHFileOperation
JvSimIndicator                          =JvSimIndicator
JvSimLogic                              =JvSimLogic
JvSimPID                                =JvSimPID
JvSimPIDLinker                          =JvSimPIDLinker
JvSimpleXml                             =JvSimpleXml
JvSimScope                              =JvSimScope
JvSLDMappingEditorDialog                =JvSLDMappingEditorDialog
JvSlider                                =JvSlider
JvSoundControl                          =JvSoundControl
JvSpacer                                =JvSpacer
JvSpecialImage                          =JvSpecialImage
JvSpecialProgress                       =JvSpecialProgress
JvSpeedbar                              =JvSpeedbar
JvSpeedbarSetupForm                     =JvSpeedbarSetupForm
JvSpeedButton                           =JvSpeedButton
JvSpellChecker                          =JvSpellChecker
JvSpellerForm                           =JvSpellerForm
JvSpellIntf                             =JvSpellIntf
JvSpin                                  =JvSpin
JvSplashWindow                          =JvSplashWindow
JvSplit                                 =JvSplit
JvSplitter                              =JvSplitter
JvStarfield                             =JvStarfield
JvStartMenuButton                       =JvStartMenuButton
JvStaticText                            =JvStaticText
JvStatusBar                             =JvStatusBar
JvStdEditActions                        =JvStdEditActions
JvSticker                               =JvSticker
JvStringGrid                            =JvStringGrid
JvStringHolder                          =JvStringHolder
JvStringListToHtml                      =JvStringListToHtml
JvStrings                               =JvStrings
JvStrToHtml                             =JvStrToHtml
JvSwitch                                =JvSwitch
JvSyncSplitter                          =JvSyncSplitter
JvSysRequirements                       =JvSysRequirements
JvSystemPopup                           =JvSystemPopup
JvTabBar                                =JvTabBar
JvTabBarXPPainter                       =JvTabBarXPPainter
JvTextListBox                           =JvTextListBox
JvTFAlarm                               =JvTFAlarm
JvTFDays                                =JvTFDays
JvTFGantt                               =JvTFGantt
JvTFGlance                              =JvTFGlance
JvTFGlanceTextViewer                    =JvTFGlanceTextViewer
JvTFManager                             =JvTFManager
JvTFMonths                              =JvTFMonths
JvTFSparseMatrix                        =JvTFSparseMatrix
JvTFUtils                               =JvTFUtils
JvTFWeeks                               =JvTFWeeks
JvThemes                                =JvThemes
JvThread                                =JvThread
JvThreadDialog                          =JvThreadDialog
JvThreadTimer                           =JvThreadTimer
JvThumbImage                            =JvThumbImage
JvThumbnails                            =JvThumbnails
JvThumbViews                            =JvThumbViews
JvTimeLimit                             =JvTimeLimit
JvTimeLine                              =JvTimeLine
JvTimer                                 =JvTimer
JvTimerList                             =JvTimerList
JvTipOfDay                              =JvTipOfDay
JvTMTimeLine                            =JvTMTimeLine
JvToolBar                               =JvToolBar
JvToolEdit                              =JvToolEdit
JvTracker                               =JvTracker
JvTranslateString                       =JvTranslateString
JvTranslator                            =JvTranslator
JvTransparentButton                     =JvTransparentButton
JvTrayIcon                              =JvTrayIcon
JvTurtle                                =JvTurtle
JvTypes                                 =JvTypes
JvUnicodeCanvas                         =JvUnicodeCanvas
JvUnicodeEditor                         =JvUnicodeEditor
JvUnicodeHLEditor                       =JvUnicodeHLEditor
JvUninstallControls                     =JvUninstallControls
JvUpDown                                =JvUpDown
JvUrlGrabbers                           =JvUrlGrabbers
JvUrlListGrabber                        =JvUrlListGrabber
JvValidateEdit                          =JvValidateEdit
JvValidators                            =JvValidators
JvVersionControlActions                 =JvVersionControlActions
JvVersionControlActionsEngine           =JvVersionControlActionsEngine
JvVersionControlActionsEngineFileListBox=JvVersionControlActionsEngineFileListBox
JvVersionInfo                           =JvVersionInfo
JvVirtualKeySelectionFrame              =JvVirtualKeySelectionFrame
JvWaitingGradient                       =JvWaitingGradient
JvWaitingProgress                       =JvWaitingProgress
JvWallpaperEditForm                     =JvWallpaperEditForm
JvWavePlayer                            =JvWavePlayer
JvWin32                                 =JvWin32
JvWinampLabel                           =JvWinampLabel
JvWinDialogs                            =JvWinDialogs
JvWinHelp                               =JvWinHelp
JvWizard                                =JvWizard
JvWizardCommon                          =JvWizardCommon
JvWizardRouteMapList                    =JvWizardRouteMapList
JvWizardRouteMapNodes                   =JvWizardRouteMapNodes
JvWizardRouteMapSteps                   =JvWizardRouteMapSteps
JvWndProcHook                           =JvWndProcHook
JvxCheckListBox                         =JvxCheckListBox
JvXmlDatabase                           =JvXmlDatabase
JvXmlTree                               =JvXmlTree
JvXPBar                                 =JvXPBar
JvXPButtons                             =JvXPButtons
JvXPCheckCtrls                          =JvXPCheckCtrls
JvXPContainer                           =JvXPContainer
JvXPCore                                =JvXPCore
JvXPCoreUtils                           =JvXPCoreUtils
JvXPProgressBar                         =JvXPProgressBar
JvxSlider                               =JvxSlider
JvYearGrid                              =JvYearGrid
JvYearGridEditForm                      =JvYearGridEditForm
JvZlibMultiple                          =JvZlibMultiple
JvZoom                                  =JvZoom
ModuleLoader                            =ModuleLoader
mscoree_TLB                             =mscoree_TLB
mscorlib_TLB                            =mscorlib_TLB
MSHelpServices_TLB                      =MSHelpServices_TLB
MSTask                                  =MSTask
ObjSel                                  =ObjSel
pcre                                    =pcre
Ras32                                   =Ras32
SetupApi                                =SetupApi
sevenzip                                =sevenzip
Snmp                                    =Snmp
VFW                                     =VFW
Winamp                                  =Winamp
WinConvTypes                            =WinConvTypes
zlibh                                   =zlibh
