abort=Abort
abs=Abs
acol=ACol
acolor=AColor
acommand=ACommand
acomponent=AComponent
acount=ACount
adate=ADate
aday=ADay
addmrustringw=AddMRUStringW
addpathbackslash=AddPathBackSlash
addpchar=AddPChar
afilename=AFileName
afont=AFont
aglyph=AGlyph
ahandle=AHandle
aheight=AHeight
ahighlighter=AHighLighter
aint=AInt
aitem=AItem
akbottom=akBottom
akind=AKind
akleft=akLeft
akright=akRight
aktop=akTop
allocatehwnd=AllocateHWnd
aname=AName
ansicomparetext=AnsiCompareText
ansiuppercase=AnsiUpperCase
aowner=AOwner
aplugin=APlugIn
arect=ARect
arow=ARow
aspeedbar=ASpeedBar
assigned=Assigned
astate=AState
astr=AStr
atime=ATime
awidth=AWidth
aword=AWord
backspaceunindents=BackSpaceUnindents
bandwidth=BandWidth
bcharset=bCharSet
bde=BDE
bdeconst=bdeconst
bkok=bkOK
bmp=Bmp
bof=BOF
bookmark=Bookmark
bookmarkvalid=BookmarkValid
bool=BOOL
boolean=boolean
borderstyle=BorderStyle
break=break
btncancel=btnCancel
btnok=btnOk btnOK
btnokclick=btnOKClick
byte=byte
bytesperscanline=BytesPerScanLine
callendpaint=CallEndPaint
canvas=Canvas
ccaption=cCaption
cfilename=cFileName
changebookmark=ChangeBookmark
char=char
charset=CharSet
checkboxes=CheckBoxes
checkinactive=CheckInActive
checks=checks
cheight=cHeight
chttpapp=cHTTPApp
cl3ddkshadow=cl3DDkShadow
classname=ClassName
clbtnface=clBtnFace
clbtnhighlight=clBtnHighlight
clhighlight=clHighlight
clhighlighttext=clHighlightText
clientheight=ClientHeight
clientrect=ClientRect
clipboardcopy=ClipBoardCopy
clipboardcut=ClipBoardCut
clipboardpaste=ClipBoardPaste
clipbrd=Clipbrd
clips=Clips
closeclipboard=CloseClipBoard
clsid=CLSID
cm_designhittest=CM_DESIGNHITTEST
cm_getdatalink=CM_GETDATALINK
cm_parentcolorchanged=CM_PARENTCOLORCHANGED
cm_release=CM_RELEASE
cmdesignhittest=CMDesignHitTest
cmdline=CmdLine
cmdshow=CmdShow
cmenabledchanged=CMEnabledChanged
cmgetdatalink=CMGetDataLink
cmvisiblechanged=CMVisibleChanged
code=Code
col=Col
contextid=ContextID
controlstyle=ControlStyle
cookie=Cookie
costheta=CosTheta
couninitialize=CoUninitialize
count=Count
counter=Counter
create=Create
create_new_console=CREATE_NEW_CONSOLE
createmrulistw=CreateMRUListW
crlf=CRLF
csidl=CSIDL
cstring=cString
csysutils=cSysUtils
ctl3d=Ctl3D
curband=CurBand
curprops=CurProps
currency=Currency
cursor=Cursor
database=Database
datalink=DataLink
dataobj=DataObj
dataset=DataSet
datasetname=DataSetName
datasource=DataSource
datasourcefixed=DataSourceFixed
db=DB
dbcommon=DBCommon
dbconsts=DBConsts
dbctrls=DBCtrls
dbgrids=DBGrids
dbierrs=DBIErrs
dbinolock=dbiNoLock
dbiprocs=DBIProcs
dbiresult=DBIResult
dbisetprop=DBiSetProp
dbitypes=DBITypes
dbtables=DBTables
default=Default
defocuscontrol=DeFocusControl
dispparams=DispParams
dllname=DLLName
docountdown=DoCountDown
doicondblclick=DoIconDblClick
dontscroll=DontScroll
drfrombottom=drFromBottom
drive=Drive
dsndbcst=DsnDbCst
dtstring=dtString
dvaspect=dvAspect
dword=DWORD
dwplatformid=dwPlatformID
dwprocessid=dwProcessID
ecbackspace=ecBackSpace
ecclipboardpaste=ecClipBoardPaste
ecunindent=ecUnIndent
edbengineerror=EDBEngineError
editkeydown=EditKeyDown
ejvpluginerror=EJvPlugInError
emptyclipboard=EmptyClipBoard
emptystr=EmptyStr
enabled=Enabled
enforcemaxvalue=EnForceMaxValue
enummrulistw=EnumMRUListW
eof=EOF
error=Error
excepinfo=ExcepInfo
exception=Exception
exename=ExeName
exit=Exit
expanduncfilename=ExpandUNCFileName
extctrls=ExtCtrls
extended=Extended
extension=Extension
extractfiledir=ExtractFileDir
extractfilename=ExtractFileName
false=false
fbandform=FBandForm
fbitmap=FBitmap
fbof=FBOF
fbuttonarray=FButtonArray
fcallback=FCallBack
fcolormap=FColorMap
fctoh=FCToH
fcurrentrecord=FCurrentRecord
fcurrpos=FCurrPos
fdatalink=FDataLink
fdialog=FDialog
fdrag=FDrag
fencoded=FEncoded
fendpara=FEndPara
feof=FEOF
ffile=FFile
ffilename=FFileName
ffillfont=FFillFont
ffillmode=FFillMode
fflags=FFlags
fflat=FFlat
ffreememory=FFreeMemory
fglyphdrawer=FGlyphDrawer
fgroupindex=FGroupIndex
fhighlighter=FHighLighter
fhilitecolor=FHiLiteColor
fhilitetext=FHiLiteText
fid3=FID3
fid3v2=FID3v2
filename=FileName
filenamew=FileNameW
fillmode=FillMode
fillrect=FillRect
fimagelist=FImageList
fimages=FImages
fimagesize=FImageSize
fimglist=FImgList
findmrustringw=FindMRUStringW
finifile=FIniFile
fitems=FItems
fjoystick1=FJoyStick1
flags=Flags
flines=FLines
flist=FList
fmail=FMail
fmargin=FMargin
fmask=FMask
fmimetype=FMimeType
fmouseexit=FMouseExit
fmultiline=FMultiLine
foldstyle=FOldStyle
fonafterload=FOnAfterLoad
fonbeforeload=FOnBeforeLoad
fonctl3dchanged=FOnCtl3DChanged
fonextractfile=FOnExtractFile
fonfiles=FOnFiles
fonmouseenter=FOnMouseEnter
fonmouseleave=FOnMouseLeave
fonneed=FOnNeed
fonnewcommand=FOnNewCommand
fonparentcolorchanged=FOnParentColorChanged
fonpluginerror=FOnPlugInError
fonurlclick=FOnURLClick
foptions=FOptions
formatetc=FormatEtc
forward=forward
foutputbuffer=FOutputBuffer
fowysiwyg=foWysiWyg
fpcpos=FPCPos
fphototypes=FPhotoTypes
fpicklist=FPickList
fplaylist=FPlayList
fplugininfos=FPluginInfos
fpopup=FPopup
fpopupmenu=FPopupMenu
frame3d=Frame3D
framelistbox=FrameListBox
free=Free
freeandnil=FreeAndNil
freebookmark=FreeBookmark
freepidl=FreePIDL
frm=frm
fscrollsaved=FScrollSaved
fsimplemapi=FSimpleMapi
fsmdichild=fsMDIChild
fsstrikeout=fsStrikeOut
fstarfield=FStarfield
fstate=FState
fsunderline=fsUnderline
ftguid=ftGuid
fthumb1=FThumb1
fthumb2=FThumb2
ftimer=FTimer
ftlastwritetime=ftLastWriteTime
ftoday=FToday
ftsmallint=ftSmallint
ftype=FType
fupdatecount=FUpdateCount
fupdatelock=FUpdateLock
furl=FURL
fusername=FUserName
fwait=FWait
fwordwrap=FWordWrap
getasynckeystate=GetAsyncKeyState
getbookmark=GetBookmark
getbuttonname=GetButtonName
getfirstchild=GetFirstChild
getfocus=GetFocus
gethotkey=GetHotKey
getmodulefilename=GetModuleFileName
getnextsibling=GetNextSibling
getpicklist=GetPickList
getpopupmenu=GetPopupMenu
getprevsibling=GetPrevSibling
getshowascheckbox=GetShowAsCheckBox
getusername=GetUserName
gotobookmark=GotoBookmark
grayscale=GrayScale
grok=grOK
haccel=HAccel
handle=Handle
handletype=HandleType
hbrush=HBRUSH
hcursor=HCURSOR
hdbicur=HDBICur
hdbidb=HDBIDB
hdbifilter=HDBIFilter
hdbiobj=HDBIObj
hdc=HDC
hdrop=HDROP
hfont=HFONT
hglobal=HGLOBAL
hi=Hi
hicon=HICON
highlight=HighLight
highlightcolor=HighLightColor
highlighter=HighLighter
hinst=HINST
hinstance=HInstance
hinternet=HINTERNET
hkey=HKEY
hlsql=hlSQL
hmenu=HMENU
hmodule=HMODULE
hpalette=HPALETTE
hresult=HRESULT
hrgn=HRGN
htmltags=HTMLTags
htnowhere=HTNOWHERE
hwnd=HWND
hwndowner=hWndOwner
hwndparent=hWndParent
icon=Icon
ictrlid=iCtrlID
idcmd=idCmd
iheight=IHeight
iid=IID
iifmultiline=iifMultiLine
ild_normal=ILD_NORMAL
ild_transparent=ILD_TRANSPARENT
imageindex=ImageIndex
images=Images
index=Index
inifile=IniFile
initfromdataset=InitFromDataSet
int=Int
integer=integer
intersectrect=InterSectRect
inttostr=IntToStr
irsnoresize=irsNoReSize
isfocused=IsFocused
isleapyear=IsLeapYear
isnt=IsNT
itemdata=ItemData
itemdblclick=ItemDblClick
itemheight=ItemHeight
itemid=ItemID
itemwidth=ItemWidth
iwidth=IWidth
jclunicode=JclUnicode
jpeg=jpeg
jpegimage=JPegImage
jvcombobox=JvComboBox
jvdbeditors=JvDBEditors
jvdbprgrss=JvDBPrgrss
jvdsadialog=JvDSADialog
jvhlediteditor=JvHLEditEditor
jvid3v1=JvID3v1
jvid3v2=JvID3v2
jvid3v2types=JvID3v2Types
jvimagewindow=JvImageWindow
jvlookout=JvLookOut
jvshfileop=JvSHFileOp
jvspeedbar=JvSpeedBar
jvthumbnails=JvThumbNails
jvthumbviews=JvThumbViews
keyword=KeyWord
ldate=lDate
left=Left
lend=lEnd
length=Length
line=Line
lines=Lines
lleft=lLeft
lo=Lo
longbool=LongBool
longint=Longint
longword=Longword
loop=Loop
lparam=lParam
lpos=lPos
lpstr=LPSTR
lresult=lResult
lscreenrect=lScreenRect
lstr=lStr
lstream=lStream
lstrlen=lStrLen
ltop=lTop
mapvirtualkey=MapVirtualKey
mask=Mask
max=Max
maxlength=MaxLength
maxlongint=MaxLongint
mbok=mbOK
menu=Menu
menuid=MenuID
message=Message
min=Min
modalresults=ModalResults
mousetocell=MouseToCell
mrok=mrOK
msec=MSec
msg=Msg
msgid=MsgID
multiline=MultiLine
name=Name
nmdaystate=NMDayState
nmhdr=NMHDR
nodeclass=NodeClass
noerror=NOERROR
npos=nPos
null=NULL
nulldate=NullDate
numbers=Numbers
numstr=NumStr
obj=Obj
odnewdialogstyle=odNewDialogStyle
offset=Offset
offsetrect=OffsetRect
ofs=ofs
ok=OK
okbtn=OKBtn
okbtnclick=OKBtnClick
okbutton=OKButton
oldfilename=OldFileName
oldfontcolor=OldFontColor
oldfontstyles=OldFontStyles
oleuninitialize=OleUninitialize
onchange=OnChange
oncontextpopup=OnContextPopup
onkeyup=OnKeyUp
onmousedown=OnMouseDown
onundock=OnUnDock
onurlclick=OnURLClick
openclipboard=OpenClipboard
ord=Ord
originalfilename=OriginalFileName
outputmode=OutputMode
overload=Overload
pagenum=PageNum
pamultiselect=paMultiSelect
param2=Param2
params=Params
paramsort=ParamSort
parentctl3d=ParentCtl3D
parentform=ParentForm
passwordchar=PasswordChar
pbyte=PByte
pchar=PChar
pcpos=PCPos
pf1bit=pf1bit
pf24bit=pf24bit
pf4bit=pf4bit
pf8bit=pf8bit
pfdbicallback=pfDBICallBack
phonebook=PhoneBook
picklist=PickList
pid=PID
pidl=PIDL
pinteger=PInteger
pitemidlist=PItemIDList
pixelformat=PixelFormat
planes=Planes
plgcustom=plgCustom
plugin=PlugIn
pluginlist=PlugInList
pmalloc=PMalloc
pmxor=pmXOR
pnext=PNext
point=Point
pointer=Pointer
polestr=POleStr
polyline=PolyLine
popup=Popup
popupmenu=PopupMenu
pqcolor=PQColor
preamp=PreAmp
pred=Pred
prequestinfos=PRequestInfos
pressedok=PressedOK
prgbarray=PRGBArray
prgbtriplearray=PRGBTripleArray
protected=protected
pshnamemapping=PSHNameMapping
psmallint=PSmallint
ptr=Ptr
pwidechar=PWideChar
rasentryname=RASEntryName
rc3_cursor=RC3_CURSOR
rc3_icon=RC3_ICON
rc3_stockicon=RC3_STOCKICON
rc_wallpaperstyle=RC_WallpaperStyle
readfilenames=ReadFileNames
readln=ReadLn
realign=Realign
reallocmem=ReallocMem
recprops=RecProps
recreatewnd=RecreateWnd
rect=Rect
redrawcontrol=RedrawControl
refreshfont=RefreshFont
registerclasses=RegisterClasses
regitem=RegItem
reline=ReLine
reobject=ReObject
replaceallstr=ReplaceAllStr
resid=ResID
result=Result
rgbmin=RGBMin
rgbwidth=RGBWidth
rollback=RollBack
rootkey=RootKey
round=round
rows=Rows
rsrc=RSrc
sbtn=SBtn
sc_dragmove=SC_DRAGMOVE
scanline=ScanLine
sdatasetclosed=SDataSetClosed
self=Self
sender=Sender
sendmessage=SendMessage
setactiveoutlook=SetActiveOutLook
setalignment=SetAlignment
setgstyle=SetGStyle
sethotkey=SetHotKey
setid=SetID
setmultiline=SetMultiLine
setshowascheckbox=SetShowAsCheckBox
seturl=SetURL
setviewportorgex=SetViewPortOrgEx
shellapi=ShellAPI
shfileoperation=SHFileOperation
shgetfileinfo=SHGetFileInfo
shmodule=SHModule
shortcut=ShortCut
shortint=Shortint
showascheckbox=ShowAsCheckBox
showcheckbox=ShowCheckBox
showcmd=ShowCmd
showhint=ShowHint
shstate=ShState
sid3invalidcharinlist=SID3InvalidCharInList
sid_ifolderfiltersite=SID_IFolderFilterSite
sinvaliddate=sInvalidDate
sinvalidimage=SInvalidImage
size=Size
sizeof=sizeof
sizeofresource=SizeOfResource
sjvinspdatastrtoolong=sJvInspDataStrTooLong
sleep=sleep
smallint=Smallint
smsgdlgerror=SMsgDlgError
snotsupported=SNotSupported
snull=SNull
softdistinfo=SOFTDISTINFO
src=Src
srccopy=SRCCOPY
srch=Srch
state=State
stime=STime
stored=stored
stretchblt=StretchBlt
string=string
strtoint=StrToInt
strvsp2=StrVsp2
style=Style
subitems=SubItems
substr=SubStr
succeeded=Succeeded
sysutils=SysUtils
szdbase=szDBASE
szparadox=szPARADOX
szusername=szUSERNAME
tabindex=TabIndex
taddmrustring=TAddMruString
taddmrustringw=TAddMruStringW
taniname=TAniName
tbitmap=TBitmap
tbookmark=TBookmark
tbookmarks=TBookmarks
tcmdesignhittest=TCMDesignHitTest
tcmforcesize=TCMForceSize
tcombobox=TComboBox
tcomboboxstyle=TComboBoxStyle
tcomplex=TComplex
tcplapplet=TCPLApplet
tcplinfo=TCPLInfo
tcustomlistbox=TCustomListBox
tdatabase=TDatabase
tdate=TDate
tdbeditshowevent=TDBEditShowEvent
tdberror=TDBError
tedit=TEdit
test=Test
text=Text
textfile=TextFile
texttoshortcut=TextToShortCut
tfont=TFont
tfrmolbeditor=TfrmOLBEditor
tfrmscheduleeditor=TfrmScheduleEditor
thandle=THandle
thighlighter=THighLighter
timagelist=TImageList
titlecolor=TitleColor
tjoystick=TJoyStick
tjpegimage=TJPegImage
tjvalarmitem=TJvAlarmItem
tjvbandform=TJvBandForm
tjvbasethumbview=TJvBaseThumbView
tjvclipboardcommand=TJvClipboardCommand
tjvcombobox=TJvComboBox
tjvcustomlookoutbutton=TJvCustomLookOutButton
tjvhtlistbox=TJvHtListBox
tjvid3frameid=TJvID3frameID
tjvid3timestampframe=TJvID3TimeStampFrame
tjvid3v2=TJvID3v2
tjvinspectordotnetpainter=TJvInspectorDotNetPainter
tjvlookoutbutton=TJvLookOutButton
tjvoutlookbarbutton=TJvOutlookBarButton
tjvoutlookbarbuttons=TJvOutlookBarButtons
tjvoutlookbarpage=TJvOutlookBarPage
tjvplaylist=TJvPlayList
tjvplugin=TJvPlugIn
tjvrolloutcolors=TJvRollOutColors
tjvrolloutimageoptions=TJvRollOutImageOptions
tjvsimplexmlelemcdata=TJvSimpleXmlElemCData
tjvsimplexmlelemdoctype=TJvSimpleXmlElemDocType
tjvspeedbarsection=TJvSpeedBarSection
tjvstringlisttohtml=TJvStringListToHtml
tjvthumbnail=TJvThumbNail
tkstring=tkString
tlargeintfield=TLargeIntField
tmetafile=TMetafile
tmpcol=TmpCol
tmpflags=TmpFlags
tnmdaystate=TNMDayState
tnmhdr=TNMHdr
tnonclientmetrics=TNonClientMetrics
tobject=TObject
tofstruct=TOFStruct
toolbutton=ToolButton
topenfilenameex=TOpenFileNameEx
tpopupmenu=TPopupMenu
tqrcustomband=TQRCustomBand
tquickrep=TQuickRep
transparent=Transparent
trasconnstatus=TRASConnStatus
trasdialparams=TRASDialParams
trect=TRect
treginifile=TRegIniFile
trgbtriple=TRGBTriple
true=true
trunc=trunc
tscrollmode=TscrollMode
tshfileinfo=TSHFileInfo
tshfileopstruct=TSHFileOpStruct
tshiftstate=TShiftState
tshortcut=TShortCut
tstartupinfo=TStartupInfo
tstringlist=TStringlist
tstrings=TStrings
ttextmetric=TTextMetric
ttreenode=TTreeNode
twin32finddata=TWin32FindData
twindowplacement=TWindowPlacement
twmerasebkgnd=TWMEraseBkGnd
twmgetdlgcode=TWMGetDlgCode
twmnchittest=TWMNCHitTest
twmnclbuttondown=TWMNCLButtonDown
twmsettext=TWMSetText
typeinfo=typeinfo
ucallbackmessage=uCallBackMessage
ufemail=ufEMail
uid=uID
uint=UINT
uitemstate=uItemState
unhookcontrol=UnHookControl
unhookmainwindow=UnHookMainWindow
unpause=UnPause
unregisterchanges=UnRegisterChanges
unregistergraphicclass=UnRegisterGraphicClass
unregisterwndprochook=UnRegisterWndProcHook
updatecount=UpdateCount
updatescrollbars=UpdateScrollBars
uppercase=UpperCase
urlclick=URLClick
username=UserName
usersidoffset=UserSidOffset
uses=uses
varbyref=VarByRef
variant=Variant
varsmallint=varSmallint
vboolean=vBoolean
ver_platform_win32_nt=VER_PLATFORM_WIN32_NT
vextended=vExtended
vinteger=vInteger
vk_insert=VK_INSERT
vpointer=vPointer
vresult=vResult
vsmallint=vSmallint
vstring=vString
vtype=vType
vvariant=vVariant
widestring=WideString
wm_cancelmode=WM_CANCELMODE
wmerasebkgnd=WMEraseBkGnd
wmgetdlgcode=WMGetDlgCode
wmnclbuttondown=WMNCLButtonDown
wordbool=WordBool
wordwrap=WordWrap
wparam=wParam
writebuffer=WriteBuffer
writeln=Writeln
yhotspot=yHotSpot
