lbDPVer.inc=jvcl.inc
lbRegister=JvDockingReg
lbConjoinDockHost=JvDockConjoinHost
lbDelphiDockStyle=JvDockDelphiStyle
lbDockableForm=JvDockableForm
lbDockFormControl=JvDockControlForm
lbDockHashTable=JvDockHashTable
lbDockInfo=JvDockInfo
lbDockSupportControl=JvDockSupportControl
lbDockTree=JvDockTree
lbGlobal=JvDockGlobals
lbPropertyReg=JvDockPropertyEditors
lbTabDockHost=JvDockTabHost
lbVCDockStyle=JvDockVCStyle
lbVIDDockStyle=JvDockVIDStyle
lbVSNETDockStyle=JvDockVSNetStyle
SupportClass=JvDockSupportClass
SupportProc=JvDockSupportProc
TlbTabDockHost=TJvDockTabHost
TlbVCConjoinServerOption=TJvDockVCConjoinServerOption
TlbVCTabServerOption=TJvDockVCTabServerOption
TlbVCDockStyle=TJvDockVCStyle
TlbVCDockSplitter=TJvDockVCSplitter
TlbVCDockPanel=TJvDockVCPanel
TlbVCConjoinPanel=TJvDockVCConjoinPanel
TlbVCTabPageControl=TJvDockVCTabPageControl
TZoneSizeStyle=TJvDockZoneSizeStyle
TlbVCDockZone=TJvDockVCZone
TlbVCDockTree=TJvDockVCTree
TlbVCDragDockObject=TJvDockVCDragDockObject
TlbTempWinControl=TJvTempWinControl
TlbVIDConjoinServerOption=TJvDockVIDConjoinServerOption
TlbVIDTabServerOption=TJvDockVIDTabServerOption
TSystemInfoChange=TJvDockSystemInfoChangeEvent
FSystemInfoChange=FOnSystemInfoChange
property SystemInfoChange=property OnSystemInfoChange
TlbVIDDockStyle=TJvDockVIDStyle
TlbVIDDockSplitter=TJvDockVIDSplitter
TlbVIDDockPanel=TJvDockVIDPanel
TlbVIDConjoinPanel=TJvDockVIDConjoinPanel
TlbVIDDockZone=TJvDockVIDZone
TlbVIDDockTree=TJvDockVIDTree
TlbVIDTabPageControl=TJvDockVIDTabPageControl
TlbVIDDockTabSheet=TJvDockVIDTabSheet
TlbTabPanel=TJvDockTabPanel
TlbTabPanelClass=TJvDockTabPanelClass
TlbVIDTabPageControl=TJvDockVIDTabPageControl
TlbVIDDragDockObject=TJvDockVIDDragDockObject
TlbVSNETConjoinServerOption=TJvDockVSNETConjoinServerOption
TlbVSNETTabServerOption=TJvDockVSNETTabServerOption
TlbVSNETChannelOption=TJvDockVSNETChannelOption
TlbVSNETChannelOptionClass=TJvDockVSNETChannelOptionClass
TlbVSBlock=TJvDockVSBlock
TlbVSChannel=TJvDockVSChannel
TlbVSNETDockPanel=TJvDockVSNETPanel
TlbVSPopupPanel=TJvDockVSPopupPanel
TlbVSPopupPanelSplitter=TJvDockVSPopupPanelSplitter
TlbVSPane=TJvDockVSPane
TBlockType=TJvDockBlockType
TVSChannelState=TJvDockChannelState
TPopupPanelAnimateStyle=TJvDockPoppupPanelAnimateStyle
TlbVSChannelClass=TJvDockVSChannelClass
TlbVSNETDockStyle=TJvDockVSNETStyle
TlbVSNETDockSplitter=TJvDockVSNETSplitter
TlbVSNETConjoinPanel=TJvDockVSNETConjoinPanel
TBtnState=TJvDockBtnState
TlbVSNETDockZone=TJvDockVSNETZone
TlbVSNETDockTree=TJvDockVSNETTree
TlbVSNETDockTabSheet=TJvDockVSNETTabSheet
TlbVSNETTabPanel=TJvDockVSNETTabPanel
TlbVSNETTabPageControl=TJvDockVSNETTabPageControl
TlbVSNETDragDockObject=TJvDockVSNETDragDockObject
TlbVSPopupPanelSplitter=TJvDockVSPopupPanelSplitter
TlbBaseTree=TJvDockBaseTree
TlbBaseZone=TJvDockBaseZone
TScanZoneNotification=TJvDockScanZoneNotification
TlbTreeZoneClass=TJvDockTreeZoneClass
TScanTreeZoneProc=TJvDockScanTreeZoneProc
TlbBaseTree=TJvDockBaseTree
TlbBaseGetFormEventComponent=TJvDockBaseGetFormEventComponent
TListScanKind=TJvDockListScanKind
lb_StreamDataToString=JvDockStreamDataToString
lb_StringToStreamData=JvDockStringToStreamData
lb_FindDockFormWithName=JvDockFindDockFormWithName
lb_FindDockServerFormWithName=JvDockFindDockServerFormWithName
lb_FindDockClientFormWithName=JvDockFindDockClientFormWithName
lb_FindDockServerFromDockManager=JvDockFindDockServerFromDockManager
lb_FindDockClientFromDockManager=JvDockFindDockClientFromDockManager
lb_FindDockFormFromScreen=JvDockFindDockFormFromScreen
lb_GetMinOffset=JvDockGetMinOffset
lb_GetNoNClientMetrics=JvDockGetNoNClientMetrics
lb_GetSysCaptionHeight=JvDockGetSysCaptionHeight
lb_GetSysBorderWidth=JvDockGetSysBorderWidth
lb_GetSysCaptionHeightAndBorderWidth=JvDockGetSysCaptionHeightAndBorderWidth
lb_GetActiveTitleBeginColor=JvDockGetActiveTitleBeginColor
lb_GetActiveTitleEndColor=JvDockGetActiveTitleEndColor
lb_GetInactiveTitleBeginColor=JvDockGetInactiveTitleBeginColor
lb_GetInactiveTitleEndColor=JvDockGetInactiveTitleEndColor
lb_GetTitleFontColor=JvDockGetTitleFontColor
lb_GetActiveTitleFontColor=JvDockGetActiveTitleFontColor
lb_GetInactiveTitleFontColor=JvDockGetInactiveTitleFontColor
lb_GetTitleFont=JvDockGetTitleFont
lb_LockWindow=JvDockLockWindow
lb_UnLockWindow=JvDockUnLockWindow
lb_CreateNCMessage=JvDockCreateNCMessage
lb_ExchangeOrient=JvDockExchangeOrient
lb_GetControlOrient=JvDockGetControlOrient
lb_GetControlSize=JvDockGetControlSize
DS_Unknow=JvDockState_Unknown
DS_Docking=JvDockState_Docking
DS_Floating=JvDockState_Floating
TlbSplitterSize=TJvDockSplitterSize
TlbDockBaseControl=TJvDockBaseControl
TlbDockServer=TJvDockServer
TlbDockClient=TJvDockClient
TlbConjoinPanel=TJvDockConjoinPanel
TlbTabPageControl=TJvDockTabPageControl
TlbConjoinDockHostForm=TJvDockConjoinHostForm
TlbTabDockHostForm=TJvDockTabHostForm
TlbDockSplitter=TJvDockDockSplitter
TSetDockPanelSizeFrom=TJvDockSetDockPanelSizeFrom
TlbDockPanel=TJvDockPanel
TlbAdvDockPanel=TJvDockAdvPanel
TlbDockPanelClass=TJvDockPanelClass
TlbDockSplitterClass=TJvDockSplitterClass
TlbConjoinPanelClass=TJvDockConjoinPanelClass
TlbTabDockClass=TJvDockTabClass
TlbSplitterStyle=TJvDockSplitterStyle
TlbBasicDockStyle=TJvDockBasicStyle
TlbBasicServerOption=TJvDockBasicServerOption
TGrabbersSize=TJvDockGrabbersSize
TSplitterWidth=TJvDockSplitterWidth
TlbBasicConjoinServerOption=TJvDockBasicConjoinServerOption
TlbBasicTabServerOption=TJvDockBasicTabServerOption
TlbBasicConjoinServerOptionClass=TJvDockBasicConjoinServerOptionClass
TlbBasicTabServerOptionClass=TJvDockBasicTabServerOptionClass
TlbBasicDockStyle=TJvDockBasicStyle
TlbAdvDockStyle=TJvDockAdvStyle
TlbDockBaseControl=TJvDockBaseControl
TGetClientAlignSizeEvent=TJvDockGetClientAlignSizeEvent
TFinishSetDockPanelSizeEvent=TJvDockFinishSetDockPanelSizeEvent
TlbDockServer=TJvDockServer
TMouseStation=TJvDockMouseStation
TNCButtonEvent=TJvDockNCButtonEvent
TNCButtonDownEvent=TJvDockNCButtonDownEvent
TNCButtonUpEvent=TJvDockNCButtonUpEvent
TNCButtonDblClkEvent=TJvDockNCButtonDblClkEvent
TNCMouseMoveEvent=TJvDockNCMouseMoveEvent
TPaintDockEvent=TJvDockPaintDockEvent
TPaintDockGrabberEvent=TJvDockPaintDockGrabberEvent
TPaintDockSplitterEvent=TJvDockPaintDockSplitterEvent
TFormHintEvent=TJvDockFormHintEvent
TlbDockClient=TJvDockClient
TlbConjoinPanel=TJvDockConjoinPanel
TlbAdvConjoinPanel=TJvDockAdvConjoinPanel
TlbTabPageControl=TJvDockTabPageControl
TlbAdvTabPageControl=TJvDockAdvTabPageControl
TlbDockableForm=TJvDockableForm
TlbConjoinDockHostForm=TJvDockConjoinDockHostForm
TlbTabDockHostForm=TJvDockTabDockHostForm
TlbConjoinDockHost=TJvDockConjoinDockHost
TlbDelphiDockStyle=TJvDockDelphiStyle
TlbDelphiDockSplitter=TJvDockDelphiSplitter
TlbDelphiDockPanel=TJvDockDelphiPanel
TlbDelphiConjoinPanel=TJvDockDelphiConjoinPanel
TlbDelphiTabPageControl=TJvDockDelphiTabPageControl
TlbDelphiDockZone=TJvDockDelphiZone
TlbDelphiDockTree=TJvDockDelphiTree
TlbDelphiDragDockObject=TJvDockDelphiDragDockObject
TlbDockableForm=TJvDockableForm
TlbDockClientHashNode=TJvDockClientHashNode
TlbDockControlHashTable=TJvDockControlHashTable
TlbDockInfoTree=TJvDockInfoTree
TDockFormStyle=TJvDockFormStyle
TlbDockInfoZone=TJvDockInfoZone
TlbDockInfoStyle=TJvDockInfoStyle
TlbDockInfoTree=TJvDockInfoTree
TlbDragDockObject=TJvDockDragDockObject
TlbCustomDockControl=TJvDockCustomControl
TlbCustomDockPanel=TJvDockCustomPanel
TlbDockCustomTabControl=TJvDockCustomTabControl
TlbDockDrawTabEvent=TJvDockDrawTabEvent
TlbDockPageControl=TJvDockPageControl
TlbDockCustomTabControl=TJvDockCustomTabControl
TlbDockTabSheet=TJvDockTabSheet
TlbDockTabSheetClass=TJvDockTabSheetClass
TlbDockPageControl=TJvDockPageControl
TlbDockTabStrings=TJvDockTabStrings
TDragOperation=TJvDockDragOperation
TlbDockPresident=TJvDockManager
TCustomDockPanelSplitter=TJvDockCustomPanelSplitter
TlbDockTree=TJvDockTree
IlbDockManager=IJvDockManager
TlbDockZone=TJvDockZone
TlbAdvDockZone=TJvDockAdvZone
TTreeScanKind=TJvDockTreeScanKind
TTreeScanPriority=TJvDockTreeScanPriority
TlbForEachZoneProc=TJvDockForEachZoneProc
TGrabbersPosition=TJvDockGrabbersPosition
TlbDockZoneClass=TJvDockZoneClass
TlbDockTree=TJvDockTree
TlbDockTreeClass=TJvDockTreeClass
TlbAdvDockTree=TJvDockAdvTree
TlbDockControlEditor=TJvDockControlEditor
TlbDockStyleEditor=TJvDockStyleEditor
TlbDockVIDTabPageControlEditor=TJvDockVIDTabPageControlEditor
LXB_D3=COMPILER3_UP
LXB_D4=COMPILER4_UP
LXB_D5=COMPILER5_UP
LXB_D6=COMPILER6_UP
gs_lb=RsDock
gs_=RsDock
lb_=JvDock
lbGlobalDockPresident=JvGlobalDockManager
President=Manager
IsLoading=JvGlobalDockIsLoading
GlobalDockClient=JvGlobalDockClient
GetSpiltterRect=GetSplitterRect
lbDockZoneClass=DockZoneClass
lbDockPanelClass=DockPanelClass
lbDockSplitterClass=DockSplitterClass
lbConjoinPanelClass=ConjoinPanelClass
lbTabDockClass=TabDockClass
lbDockPanelTreeClass=DockPanelTreeClass
lbDockPanelZoneClass=DockPanelZoneClass
lbConjoinPanelTreeClass=ConjoinPanelTreeClass
lbConjoinPanelZoneClass=ConjoinPanelZoneClass
lbConjoinServerOptionClass=ConjoinServerOptionClass
lbTabServerOptionClass=TabServerOptionClass
FlbDockPanelClass=FDockPanelClass
FlbDockSplitterClass=FDockSplitterClass
FlbConjoinPanelClass=FConjoinPanelClass
FlbTabDockClass=FTabDockClass
FlbDockPanelTreeClass=FDockPanelTreeClass
FlbDockPanelZoneClass=FDockPanelZoneClass
FlbConjoinPanelTreeClass=FConjoinPanelTreeClass
FlbConjoinPanelZoneClass=FConjoinPanelZoneClass
FlbConjoinServerOptionClass=FConjoinServerOptionClass
FlbTabServerOptionClass=FTabServerOptionClass
FlbConjoinServerOption=FConjoinServerOption
FlbTabServerOption=FTabServerOption
TlbAppEvents=TJvDockAppEvents
FlbChannelOption=FChannelOption
FlbChannelOptionClass=FChannelOptionClass
lbTabPanelClass=TabPanelClass
FlbTabPanelClass=FTabPanelClass
SelectSheet=ActiveSheet
VisibleTheetCount=VisibleSheetCount
GetVisibleTheetCount=GetVisibleSheetCount
CloseBtnZone=CloseButtonZone
ExpandBtnDown=ExpandButtonDown
AutoHideBtnDown=AutoHideButtonDown
EnableCloseBtn=EnableCloseButton
AutoHideBtnState=AutoHideButtonState
CloseBtnState=CloseButtonState
DockSiteSizeWithOrient=DockSiteSizeWithOrientation
ShiftScaleOrient=ShiftScaleOrientation
DockSiteOrient=DockSiteOrientation
CurrState=CurrentState
DockRectArr=DockRectangles
OldState=PreviousState
OldTarget=PreviousTarget
OldVisible=PreviousVisible
OldRect=PreviousRect
lbTabPanelClass=TabPanelClass
lbDockTabSheetClass=TabSheetClass
GetlbDockManager=GetJvDockManager
SetlbDockManager=SetJvDockManager
lbDockManager=JvDockManager
SourceDockClientCount=Count
VSPaneCount=Count
BlockCount=Count
PageCount=Count
DockSiteSizeA=DockSiteSizeAlternate
GetDockSiteSizeA=GetDockSiteSizeAlternate
SetDockSiteSizeA=SetDockSiteSizeAlternate
DockBaseControlListCount=Count
TempSheet=TemporarySheet
SetDockRectangles=InitDockRectangles
SetDockHeightWidthArr=InitDockHeightWidth

