dxWinXPBar=JvXPBar
TdxWinXPBarRollDirection=TJvXPBarRollDirection
TdxWinXPBarRollMode=TJvXPBarRollMode
TdxWinXPBarHitTest=TJvXPBarHitTest
TdxWinXPBarOnCanChangeEvent=TJvXPBarOnCanChangeEvent
TdxWinXPBarOnDrawItemEvent=TJvXPBarOnDrawItemEvent
TdxWinXPBarOnItemClickEvent=TJvXPBarOnItemClickEvent
TdxWinXPBarItemActionLink=TJvXPBarItemActionLink
TdxWinXPBarItemActionLinkClass=TJvXPBarItemActionLinkClass
TdxWinXPBarItem=TJvXPBarItem
TdxWinXPBarItems=TJvXPBarItems
TdxWinXPBarVisibleItems=TJvXPBarVisibleItems
TdxFadeThread=TJvXPFadeThread
TdxCustomWinXPBar=TJvXPCustomWinXPBar
TdxWinXPBar=TJvXPBar
FC_HEADER_HEIGHT=FC_HEADER_HEIGHT
FC_ITEM_MARGIN=FC_ITEM_MARGIN
dxVer.inc=jvcl.inc
dxRegister=JvXPCtrlsReg
dxPropEditors=JvXPPropertyEditors
TdxCustomImageIndexPropertyEditor=TJvXPCustomImageIndexPropertyEditor
TdxItemImageIndexPropertyEditor=TJvXPItemImageIndexPropertyEditor
TdxWinXPBarItemEditor=TJvXPBarItemEditor
dxCoreUtils=JvXPCoreUtils
dxMethodsEqual=JvXPMethodsEqual
dxDrawLine=JvXPDrawLine
dxCreateGradientRect=JvXPCreateGradientRect
dxAdjustBoundRect=JvXPAdjustBoundRect
dxDrawBoundLines=JvXPDrawBoundLines
dxConvertToGray2=JvXPConvertToGray2
dxRenderText=JvXPRenderText
dxFrame3d=JvXPFrame3d
dxColorizeBitmap=JvXPColorizeBitmap
dxSetDrawFlags=JvXPSetDrawFlags
dxPlaceText=JvXPPlaceText
dxCore=JvXPCore
dxColor_=JvXPColor_
TdxCustomStyleControl=TJvXPCustomStyleControl
TdxBoundLines=TJvXPBoundLines
TdxControlStyle=TJvXPControlStyle
TdxDrawState=TJvXPDrawState
TdxGlyphLayout=TJvXPGlyphLayout
TdxTheme=TJvXPTheme
TdxCustomComponent=TJvXPCustomComponent
TdxWinControl=TJvXPWinControl
TdxCustomControl=TJvXPCustomControl
TdxUnlimitedControl=TJvXPUnlimitedControl
TdxStyle=TJvXPStyle
TdxStyleManager=TJvXPStyleManager
TdxCustomStyleControl=TJvXPCustomStyleControl
TdxGradientColors=TJvXPGradientColors
TdxGradientStyle=TJvXPGradientStyle
TdxGradient=TJvXPGradient
dxContainer=JvXPContainer
TdxPaintEvent=TJvXPPaintEvent
TdxEnabledMode=TJvXPEnabledMode
TdxCustomContainer=TJvXPCustomContainer
TdxContainer=TJvXPContainer
dxCheckCtrls=JvXPCheckCtrls
TdxCustomCheckControl=TJvXPCustomCheckControl
TdxCheckbox=TJvXPCheckbox
dxButtons=JvXPButtons
TdxCustomButtonActionLink=TJvXPCustomButtonActionLink
TdxLayout=TJvXPLayout
TdxCustomButton=TJvXPCustomButton
TdxButton=TJvXPButton
TdxToolType=TJvXPToolType
TdxCustomToolButton=TJvXPCustomToolButton
TdxToolButton=TJvXPToolButton
DELPHI6=COMPILER6_UP
