TJvFormPlacement=TJvFormStorage
TJvRegAuto=TJvFormStorage
TJvaSQLScript=TJvBDESQLScript
TJvaCaptionButton=TJvCaptionButton
TDirection=TJvScrollTextDirection
TOnLinkClick=TJvLinkClickEvent
TOnDoneFile=TJvDoneFileEvent
TOnDoneStream=TJvDoneStreamEvent
TOnProgress=TJvProgressEvent
TOnFtpProgress=TJvFTPProgressEvent
TOnError=TJvErrorEvent
TOnPrintProgress=TJvPrintProgressEvent
TOnNextPage=TJvNextPageEvent
TOnKeyFound=TJvKeyFoundEvent
TParserInfos=TJvParserInfoList
TParserInf=TJvParserInfo
TOnParent=TJvParentEvent
TNotifyEventParams=TJvNotifyParamsEvent
TFileInformation=TJvFileInfoRec
TJvAnimations=TJvAnimation
TDropEvent=TJvDropEvent
TOnChangeColor=TJvChangeColorEvent
TVolumeRec=TJvVolumeRec
TWallpaperStyle=TJvWallpaperStyle
TTransformationKind=TJvTransformationKind
TPopupPosition=TJvPopupPosition
TBitmapStyle=TJvBitmapStyle
TGradStyle=TJvGradientStyle
TDiskRes=TJvDiskRes
TDiskStyle=TJvDiskStyle
TDiskStyles=TJvDiskStyles
TDeleteStyle=TJvDeleteStyle
TDeleteStyles=TJvDeleteStyles
TFourCC=TJvFourCC
PAniTag=PJvAniTag
TAniTag=TJvAniTag
TAniHeader=TJvAniHeader
TPositionInMenu=TJvPositionInMenu
JvGrdCpt=JvGradientCaption
JvGradientCaption=JvGradientHeaderPanel
TJvGradientCaption=TJvGradientHeaderPanel
JvAppUtils=JvJVCLUtils
JvVCLUtils=JvJVCLUtils
JvCtrlUtils=JvJVCLUtils
JvUtils=JvJVCLUtils
JvStrUtil=JvJCLUtils
JvStrUtils=JvJCLUtils
JvDateUtil=JvJCLUtils
JvDBUtil=JvBDEUtils
JvConst=JvConsts
JvCtlConst=JvConsts
JvxDConst=JvConsts
JvxRConst=JvConsts
JvDBConst=JvDBConsts
JvCHPSWDLG=JvBDECheckPasswordForm
JvDBExcpt=JvBDEExceptionForm
JvExcptDlg=JvExceptionForm
JvFDualLst=JvDualListForm
JvGradedit=JvGradientCaptionForm
JvCheckItm=JvCheckedItemsForm
JvCsvDataDefStrDsgn=JvCsvDataForm
JvDateTimeDlg=JvDateTimeForm
JvDirFrm=JvDirectoryListForm
JvID3v2Define=JvID3v2DefineForm
JvID3v2Editor=JvID3v2EditorForm
JvIColEdit=JvIconListForm
JvImagPrvw=JvImagePreviewForm
JvhtHintEditor=JvHTHintForm
JvMinMaxEd=JvMinMaxForm
JvOLBEditor=JvOutlookBarForm
JvPgMngrEd=JvPageManagerForm
JvPictEdit=JvPictureEditForm
JvPluginParams=JvPluginParamsForm
JvScheduleEditor=JvScheduleEditorForm
JvSelDSFrm=JvSelectDataSetForm.dfm
JvSbEdit=JvSpeedbarForm.dfm
JvSBSetup=JvSpeedbarSetupForm
JvStrLEdit=JvStringsForm.dfm
JvTimLstEd=JvTimerListForm.dfm
JvxLogin=JvLoginForm
JvQbnddlg=JvDBQueryParamsForm
JvHLEdPropDlg=JvHLEditorPropertyForm
JvPresrDsn=JvFormPropertiesForm
JvProgressFrm=JvProgressForm
JvActnRes=JvActnResForm
JvJVCLAbout=JvJVCLAboutForm
JvProfiler32=JvProfilerForm
JvFormLog=JvLogForm
JvgLabelEditor=JvgLabelEditorForm
JvgReportEditor=JvgReportEditorForm
JvgReportParamEditor=JvgReportParamsForm
JvgRTFPreviewEditor=JvgRTFPreviewForm
JvPageLinkEditor=JvPageLinkEditorForm
JvRegAutoEditor=JvRegAutoEditorForm
JvTreeItemsEditor=JvTreeItemsEditorForm
JvValidatorsEditor=JvValidatorsEditorForm
JvFormAlarms=JvAlarmsForm
JvFormImage=JvImageForm
JvFormParser=JvParserForm
JvFormPatch=JvPatchForm
JvFormProgress=JvProgressComponent
JvFormWallpaperEdit=JvWallpaperEditForm
JvSpeller=JvSpellerForm
JvTransparentForm=JvFormTransparent
JvImageDlg=JvImageDialog
JvActnRes=JvActnResForm
JvJVCLAbout=JvJVCLAboutForm
JvProfiler32=JvProfilerForm
JvFormLog=JvLogForm
JvgLabelEditor=JvgLabelEditorForm
JvgReportEditor=JvgReportEditorForm
JvgReportParamEditor=JvgReportParamsForm
JvgRTFPreviewEditor=JvgRTFPreviewEditorForm
JvPageLinkEditor=JvPageLinkEditorForm
JvRegAutoEditor=JvRegAutoEditorForm
JvTreeItemsEditor=JvTreeItemsEditorForm
JvValidatorsEditor=JvValidatorsEditorForm
JvProgressForm=JvProgressComponent
TJvProgressForm=TJvProgressComponent
ConvertToHTMLStringList=ConvertToHTMLStrings
JvTransLED=JvLED
TJvTransLED=TJvLED
JvBlinkingLED=JvLED
TJvBlinkingLED=TJvLED
JvRadioControl=JvDialButton
TJvRadioControl=TJvDialButton
TJvRadioDrawEvent=TJvDialDrawEvent
TJvCustomRadioControl=TJvCustomDialButton
TJvRadioAngle=TJvDialAngle
TJvRadioPointerShape=TJvDialPointerShape
JvErrProvider=JvErrorIndicator
TJvErrorProvider=TJvErrorIndicator
IJvErrorProviderClient=IJvErrorIndicatorClient
IJvErrorProvider=IJvErrorIndicator
ErrorProvider=ErrorIndicator
JvTMTL=JvTMTimeLine
JvAutoSizeCompo=JvFormAutoSize
JvPlacemnt=JvFormPlacement
JvVerInf=JvVersionInfo
JvUCB=JvUninstallCtrls
JvTimerLst=JvTimerList
JvSysComp=JvCreateProcess
JvObjStr=JvObjectStrings
JvMrgMngr=JvMergeManager
JvMouseTimerU=JvMouseTimer
JvFDualList=JvDualListForm
JvDBSecur=JvDBSecurity
JvDBRichEd=JvDBRichEdit
JvDBPrgrss=JvDBProgress
JvColorBtn=JvColorButton
JvCntScr=JvContentScroller
JvCmdEdit=JvCommandEdit
JvOLBar=JvOutlookBar
JvRegTV=JvRegistryTreeview
JvPrgrss=JvProgressUtils
JvPluginMan=JvPluginManager
JvRadioCtl=JvRadioControl
JvRecentMenuBtn=JvRecentMenuButton
JvRemLog=JvRemoteLogin
JvSHFileOp=JvSHFileOperation
JvSplshWnd=JvSplashWindow
JvSQLS=JvSQLScript
JvStartMenuBtn=JvStartMenuButton
JvStrHlder=JvStringHolder
JvRichEd=JvRichEdit
TJvxRichEdit=TJvRichEdit
JvControlPanel=JvControlPanelButton
JvClipMon=JvClipboardMonitor
JvClipView=JvClipboardViewer
JvDataConv=JvConverter
JvPageMngr=JvPageManager
JvBmpAnim=JvBmpAnimator
JvClipIcon=JvIconClipboardUtils
JvArrowBtn=JvArrowButton
JvMemDS=JvMemoryDataset
JvMagnet=JvFormMagnet
JvDlg=JvProgressForm
JvCurrEdit=JvBaseEdits
JvDBComb=JvDBCombobox
JvDBCtrl=JvDBControls
JvIcoList=JvIconList
JvPropAutoSave=JvAutoSave
JvTransBtn=JvTransparentButton
JvxLoginDlg=JvDBLoginDialog
JvProps=JvPropsStorage
JvxAnimate=JvAnimatedImage
JvMRUList=JvMRUManager
JvMRU=JvMRUList
JvObjPickerComp=JvObjectPickerDialog
TJvControlPanel=TJvControlPanelButton
TJvStartMenuBtn=TJvStartMenuButton
TJvRecentMenuBtn=TJvRecentMenuButton
JvAppletProperty=JvAppletEditor
JvBehaviorLabelProperty=JvBehaviorLabelEditor
JvChNtfyProperty=JvChangeNotifyEditor
JvTipOfDayProp=JvTipOfDayEditor
JvOutEdit=JvLookoutEditor
JvJVCLAboutProperty=JvJVCLAboutEditor
JvTimeLineEdit=JvTimeLineEditor
JvaDsgn=JvDesignerUtils
JvCsvDataDsgn=JvCsvDataEditor
JvDBUtil=JvBDEUtils
TJvxGradientCaption=TJvGradientCaption
TJvImageDlg=TJvImageDialog
TOnSortMethod=TJvListViewColumnSortEvent
TJvProgressEvent=TJvHTTPProgressEvent
TJvPrintProgressEvent=TJvProgressEvent
TProgress=TJvProgressEvent
JvgRegLibDelphi=JvGlobusReg
WidthOf=JvJCLUtils.RectWidth
HeightOf=JvJCLUtils.RectHeight
IsPointInRect=JvJCLUtils.PtInRectExclusive
PointInRect=JvJCLUtils.PtInRectInclusive
TJvClrFrm=TJvColorForm
TGraphDigitsElem=TJvgGraphDigitsElem
TGraphDigitsElemSet=TJvgGraphDigitsElemSet
TSpSymbol=TJvgSpecialSymbol
_none_=ssyNone
_colon_=ssyColon
_slash_=ssySlash
_backslash_=ssyBackslash
_deT_=dlT
_deC_=dlC
_deB_=dlB
_deTL_=dlTL
_deTR_=dlTR
_deBL_=dlBL
_deBR_=dlBR
_deDOT_=dlDOT
BackgrColor=BackgroundColor
InsertSpSymbolAt=InsertSpecialSymbolAt
TCustomJvDBTreeView=TJvCustomDBTreeView
TglExportCaptions=TJvExportCaptions
TExportRecordEvent=TJvExportRecordEvent
TExportFieldEvent=TJvExportFieldEvent
TGetLineFontEvent=TJvGetLineFontEvent
TJvFtpGrabber=TJvFtpUrlGrabber
TJvHttpGrabber=TJvHttpUrlGrabber
TJvMultiHttpGrabber=TJvUrlListGrabber
TJvButton=TJvBitBtn