EComplete=EJvComplete 
EIParserError=EJvIParserError 
ERADBMoveError=EJvDBMoveError 
ERADBTreeViewError=EJvDBTreeViewError 
ERAEditorError=EJvEditorError 
ERAI2Error=EJvInterpreterError 
ERAScrollMaxError=EJvScrollMaxError 
ERegAutoError=EJvRegAutoError 
EScriptError=EJvScriptError 
fDBMove=fJvDBMove
fDBTree=fJvDBTree
fDebug=fJvDebug
fLineNumbersMain=fJvLineNumbersMain
fPasImport=fJvPasImport
fRAControls=fJvControls
fRAEditorTest=fJvEditorTest
fRAHLEdPropDlgTestMain=fJvHLEdPropDlgTestMain
fRAHLEdPropDlgTestParams=fJvHLEdPropDlgTestParams
fRegClasses=fJvRegClasses
fTracer=fJvTracer
fTracerTest=fJvTracerTest
iMTracer=iJvMTracer
RAButtons=JvButtons
RAComponentPanel=JvComponentPanel
RaCtlConst=JvCtlConst
Ractlreg=JvCtlReg
RaDBConst=JvDBConst
RADBLookupTreeView=JvDBLookupTreeView
RADBMove=JvDBMove
radbreg=JvaDBreg
RADBTreeView=JvDBTreeView
RADBUtil=JvDBUtil
RADlg=JvDlg
RaDsgn=JvDsgn
RaDsgnIntf=JvDsgnIntf
RAEditor=JvEditor
RAHint=JvHint
RAHLEditor=JvHLEditor
RAHLEdPropDlg=JvHLEdPropDlg
RAHLParser=JvHLParser
RAHook=JvHooks
RAHtControls=JvHtControls
RAhtHintEditor=JvhtHintEditor
RAI2_Classes=JvInterpreter_Classes
RAI2_ComCtrls=JvInterpreter_ComCtrls
RAI2_Controls=JvInterpreter_Controls
RAI2_Db=JvInterpreter_Db
RAI2_Forms=JvInterpreter_Forms
RAI2_Quickrpt=JvInterpreter_Quickrpt
RAI2_StdCtrls=JvInterpreter_StdCtrls
RAI2Class=JvInterpreterClass
RAI2Error=JvInterpreterError 
RAI2Event=JvInterpreterEvent
RAI2Fm=JvInterpreterFm
RAI2Parser=JvInterpreterParser
RAIDEZoom=JvIDEZoom
raireg=JvIReg
RARegAuto=JvRegAuto
RARegAutoEditor=JvRegAutoEditor
RAScrollMax=JvScrollMax
RAScrollText=JvaScrollText
RASQLS=JvSQLS
RaStrUtil=JvStrUtil
RAUtils=JvUtils
TBackspaceUndo=TJvBackspaceUndo 
TBandBtn=TJvBandBtn 
TBeginCompoundUndo=TJvBeginCompoundUndo 
TButtonGlyph=TJvButtonGlyph 
TCaretUndo=TJvCaretUndo 
TColors=TJvColors 
TCompletion=TJvCompletion 
TCustomRADBTreeView=TCustomJvDBTreeView 
TDatabaseNameProperty=TJvDatabaseNameProperty 
TDataFieldProperty=TJvDataFieldProperty 
TDataSourceLink=TJvDataSourceLink 
TDBStringProperty=TJvDBStringProperty 
TDebugLog=TJvDebugLog 
TDeleteSelectedUndo=TJvDeleteSelectedUndo 
TDeleteTrailUndo=TJvDeleteTrailUndo 
TDeleteUndo=TJvDeleteUndo 
TEditKey=TJvEditKey 
TEditor=TJvEditor 
TEditorClient=TJvEditorClient 
TEditorStrings=TJvEditorStrings 
TEEditorZoom=TJvEEditorZoom 
TEndCompoundUndo=TJvEndCompoundUndo 
TGlyphCache=TJvGlyphCache 
TGlyphList=TJvGlyphList 
TGutter=TJvGutter 
THintEditor=TJvHintEditor 
TIniStrings=TJvIniStrings 
TInsertColumnUndo=TJvInsertColumnUndo 
TInsertTabUndo=TJvInsertTabUndo 
TInsertUndo=TJvInsertUndo 
TIParser=TJvIParser 
TKeyboard=TJvKeyboard 
TLineNumbersMain=TJvLineNumbersMain 
TListFieldProperty=TJvListFieldProperty 
TListSourceLink=TJvListSourceLink 
TLoadProgress=TJvLoadProgress 
TMainForm=TMainForm 
TMyIniFile=TJvMyIniFile 
TMyParams=TMyParams 
TOverwriteUndo=TJvOverwriteUndo 
TPasImport=TJvPasImport 
TPopupDataList=TJvPopupDataList 
TPopupTree=TJvPopupTree 
TProcItem=TJvProcItem 
TRACaptionButton=TJvaCaptionButton 
TRAColorButton=TJvaColorButton 
TRAComponentPanel=TJvComponentPanel 
TRAControlScrollBar95=TJvControlScrollBar95 
TRACustomEditor=TJvCustomEditor 
TRADBLookupControl=TJvDBLookupControl 
TRADBLookupTreeView=TJvDBLookupTreeView 
TRADBLookupTreeViewCombo=TJvDBLookupTreeViewCombo 
TRADBLookupTreeViewTree=TJvDBLookupTreeViewTree 
TRADBMove=TJvDBMove 
TRADBTreeNode=TJvDBTreeNode 
TRADBTreeView=TJvDBTreeView 
TRADBTreeViewDataLink=TJvDBTreeViewDataLink 
TRAEditor=TJvEditor 
TRAEditorCategory=TJvEditorCategory 
TRAEditorCompletionList=TJvEditorCompletionList 
TRAHint=TJvHint 
TRAHintProperty=TJvHintProperty 
TRAHLEditor=TJvHLEditor 
TRAHLEditorColorProperty=TJvHLEditorColorProperty 
TRAHLEditorParamsForm=TJvHLEditorParamsForm 
TRAHLEdPropDlg=TJvHLEdPropDlg 
TRAHLEdPropDlgEditor=TJvHLEdPropDlgEditor 
TRAhtButton=TJvHTButton 
TRAhtButtonGlyph=TJvHTButtonGlyph 
TRAhtComboBox=TJvHTComboBox 
TRAhtHintWindow=TJvHTHintWindow 
TRAhtLabel=TJvHTLabel 
TRAhtListBox=TJvhtListBox 
TRAI2Adapter=TJvInterpreterAdapter 
TRAI2Class=TJvInterpreterClass 
TRAI2ClassesEvent=TJvInterpreterClassesEvent 
TRAI2ComCtrlsEvent=TJvInterpreterComCtrlsEvent 
TRAI2Const=TJvInterpreterConst 
TRAI2ControlsEvent=TJvInterpreterControlsEvent 
TRAI2DbEvent=TJvInterpreterDbEvent 
TRAI2DMethod=TJvInterpreterDMethod 
TRAI2Event=TJvInterpreterEvent
TRAI2EventClass=TJvInterpreterEventClass
TRAI2EventDesc=TJvInterpreterEventDesc 
TRAI2Expression=TJvInterpreterExpression 
TRAI2ExtFun=TJvInterpreterExtFun 
TRAI2Fm=TJvInterpreterFm 
TRAI2Form=TJvInterpreterForm 
TRAI2FormsEvent=TJvInterpreterFormsEvent 
TRAI2Function=TJvInterpreterFunction 
TRAI2FunDesc=TJvInterpreterFunDesc
TRAI2Identifer=TJvInterpreterIdentifer 
TRAI2IdentiferList=TJvInterpreterIdentiferList 
TRAI2Method=TJvInterpreterMethod 
TRAI2Parser=TJvInterpreterParser 
TRAI2Program=TJvInterpreterProgram 
TRAI2ProgramStrings=TJvInterpreterProgramStrings 
TRAI2QuickrptEvent=TJvInterpreterQuickrptEvent 
TRAI2Reader=TJvInterpreterReader 
TRAI2RecHolder=TJvInterpreterRecHolder 
TRAI2RecMethod=TJvInterpreterRecMethod 
TRAI2Record=TJvInterpreterRecord 
TRAI2SrcUnit=TJvInterpreterSrcUnit 
TRAI2StdCtrlsEvent=TJvInterpreterStdCtrlsEvent 
TRAI2Unit=TJvInterpreterUnit 
TRAI2Var=TJvInterpreterVar
TRAI2VarList=TJvInterpreterVarList 
TRAIntegerProperty=TJvIntegerProperty 
TRANoFrameButton=TJvNoFrameButton 
TRAProgressForm=TJvProgressForm 
TRAProgressFormForm=TJvProgressFormForm 
TRAScrollBar=TJvScrollBar 
TRAScrollMax=TJvScrollMax 
TRAScrollMaxBand=TJvScrollMaxBand 
TRAScrollMaxBands=TJvScrollMaxBands 
TRAScrollMaxEditor=TJvScrollMaxEditor 
TRAScrollText=TJvaScrollText 
TRASQLScript=TJvaSQLScript 
TRegAuto=TJvRegAuto 
TRegAutoEditor=TJvRegAutoEditor 
TRegClasses=TJvRegClasses 
TRegEditor=TJvRegEditor 
TReLineUndo=TJvReLineUndo 
TReplaceUndo=TJvReplaceUndo 
TSampleViewer=TJvSampleViewer 
TScroller=TJvScroller 
TSelectUndo=TJvSelectUndo 
TSymbolColor=TJvSymbolColor 
TTracerMain=TJvTracerMain 
TTracerSocket=TJvTracerSocket 
TTrayForm=TJvTrayForm 
TWHook=TJvWHook 
RAI2Const=JvInterpreterConst
RAI2=JvInterpreter
