ANIFILE=JvAni
Animate=JvxAnimate
APPEVENT=JvAppEvent
APPUTILS=JvAppUtils
BdeUtils=JvBdeUtils
BOXPROCS=JvBoxProcs
CHECKITM=JvCheckItm
CHPSWDLG=JvChPswDlg
CLIPICON=JvClipIcon
clipmon=JvClipmon
CLIPVIEW=JvClipView
CURREDIT=JvCurrEdit
DATACONV=JvDataConv
DATEUTIL=JvDateUtil
DBEXCPT=JvDBExcpt
DBFilter=JvDBFilter
DBINDEX=JvDBIndex
DBLISTS=JvDBLists
DBPRGRSS=JvDBPrgrss
DBQBE=JvDBQBE
DBRICHED=JvDBRichEd
DBSECUR=JvDBSecur
DBUTILS=JvDBUtils
EXCPTDLG=JvExcptDlg
FDUALLST=JvFDualLst
FileUtil=JvFileUtil
GIFCTRL=JvGIFCtrl
gradedit=JvGradedit
HINTPROP=JvHintProp
ICOLEDIT=JvIColEdit
ICOLIST=JvICoList
IMAGPRVW=JvImagPrvw
LoginDlg=JvxLoginDlg
MAXMIN=JvMaxMin
Memtable=JvMemtable
MINMAXED=JvMinMaxEd
MrgMngr=JvMrgMngr
MRULIST=JvMRUList
OBJSTR=JvObjStr
OLE2AUTO=JvOLE2Auto
PAGEMNGR=JvPageMngr
PARSING=JvParsing
PGMNGRED=JvPgMngrEd
Picclip=JvPicclip
PICKDATE=JvPickDate
PICTEDIT=JvPictEdit
Placemnt=JvPlacemnt
PRESRDSN=JvPresrDsn
Qbnddlg=JvQbnddlg
RxBDEReg=JvBDEReg
RXCALC=JvCalc
RXCCONST=JvCConst
RXCLOCK=JvClock
RXCOLORS=JvColors
RXCOMBOS=JvCombos
RXCONST=JvConst
RxCtlReg=JvCtlReg
RxCtrls=JvxCtrls
RXDBCOMB=JvDBComb
RXDBCTRL=JvDBCtrl
RxDBReg=JvDBReg
RXDCONST=JvDConst
RXDICE=JvDice
RXDIRFRM=JvDirFrm
rxdsgn=JvDsgn
RxDUALLIST=JvDualList
RXGCONST=JvGConst
RXGIF=JvGIF
RxGraph=JvGraph
Rxgrdcpt=Jvgrdcpt
rxgrids=Jvgrids
RXHINTS=JvHints
RXHOOK=JvHook
RXINI=JvINI
RXLCONST=JvLConst
RXLOGIN=JvxLogin
RxLookup=JvLookup
RxMemDS=JvMemDS
Rxmenus=JvMenus
RxNotify=JvNotify
RXPRGRSS=JvPrgrss
RXPROPS=JvProps
Rxquery=JvQuery
rxremlog=JvRemlog
Rxresexp=JvResexp
RxRichEd=JvRichEd
RXSHELL=JvShell
Rxslider=JvxSlider
RXSpin=JvSpin
RXSPLIT=JvSplit
rxStrUtils=JvStrUtils
RXSWITCH=JvSwitch
RXTCONST=JvTConst
RxTimer=JvTimer
RXTOOREG=JvTooReg
RXVERINF=JvVerInf
SBEDIT=JvSbEdit
SBSETUP=JvSBSetup
SelDSFrm=JvSelDSFrm
SPEEDBAR=JvSpeedbar
SPLSHWND=JvSplshWnd
STR16=JvStr16
StrHlder=JvStrHlder
STRLEDIT=JvxStrLEdit
TIMERLST=JvTimerLst
TIMLSTED=JvTimLstEd
ToolEdit=JvToolEdit
Vclutils=JvVCLUtils
DualList=JvDualList
EComboEditError=EJvComboEditError
EFilterError=EJvFilterError
EOleError=EJvOleError
EPropReadOnly=EJvPropReadOnly
EPropWriteOnly=EJvPropWriteOnly
ERxParserError=EJvParserError
ESpeedbarError=EJvSpeedbarError
TAnimatedCursorImage=TJvAni
TAnimatedEditor=TJvAnimatedEditor
TAnimatedImage=TJvAnimatedImage
TAppEventList=TJvAppEventList
TAppEvents=TJvAppEvents
TBDEItems=TJvBDEItems
TBDENastyDataSet=TJvBDENastyDataSet
TBrowseFolderDlg=TJvBrowseFolderDlg
TBtnControl=TJvBtnControl
TButtonImage=TJvButtonImage
TCalcButton=TJvCalcButton
TCalculatorPanel=TJvCalculatorPanel
TCheckItemEditor=TJvCheckItemEditor
TCheckItemsEditor=TJvCheckItemsEditor
TCheckItemsProperty=TjvCheckItemsProperty
TCheckListBoxItem=TjvCheckListBoxItem
TCheckListBoxStrings=TJvCheckListBoxStrings
TChPswdForm=TJvChPswdForm
TClipboardMonitor=TJvClipboardMonitor
TClipboardViewer=TJvClipboardViewer
TCloneDataset=TJvCloneDataset
TCloneDbDataset=TJvCloneDbDataset
TCloneTable=TJvCloneTable
TColorComboBox=TJvColorComboBox
TComboEdit=TJvComboEdit
TComponentFormProperty=TJvComponentFormProperty
TControlHook=TJvControlHook
TConverter=TJvConverter
TCurrencyEdit=TJvValidateEdit
TCustomBDEItems=TJvCustomBDEItems
TCustomClipboardViewer=TJvCustomClipboardViewer
TCustomComboEdit=TJvCustomComboEdit
TCustomDatabaseItems=TJvCustomDatabaseItems
TCustomDateEdit=TJvCustomDateEdit
TCustomDBComboBox=TJvCustomDBComboBox
TCustomNumEdit=TJvCustomNumEdit
TCustomTableItems=TJvCustomTableItems
TDatabaseDesc=TJvDatabaseDesc
TDatabaseItems=TJvDatabaseItems
TDatabaseList=TJvDatabaseList
TDatabaseNameProperty=TJvDatabaseNameProperty
TDataSourceLink=TJvDataSourceLink
TDateEdit=TJvDateEdit
TDateProperty=TJvDateProperty
TDateTimeFormat=TJvDateTimeFormat
TDBCallback=TJvDBCallback
TDBDateEdit=TJvDBDateEdit
TDBIndexCombo=TJvDBIndexCombo
TDBListDataSet=TJvDBListDataSet
TDBLocate=TJvDBLocate
TDBLoginDialog=TJvDBLoginDialog
TDBProgress=TJvDBProgress
TDBSecurity=TJvDBSecurity
TDBStatusLabel=TJvDBStatusLabel
TDirectoryEdit=TJvDirectoryEdit
TDirectoryListDialog=TJvDirectoryListDialog
TDirnameProperty=TJvDirNameProperty
TDriveCombo=TDriveCombo
TDriverDesc=TJvDriverDesc
TEditButton=TJvEditButton
TExprParser=TexprParser
TFieldList=TJvFieldList
TFileDirEdit=TJvFileDirEdit
TFilenameEdit=TJvFilenameEdit
TFilenameProperty=TJvFilenameProperty
TFilterDataLink=TJvFilterDataLink
TFilterExpr=TjvFilterExpr
TFontComboBox=TJvFontComboBox
TFormHistory=TJvFormHistory
TFormPlacement=TjvFormPlacement
TFormPropsDlg=TJvFormPropsDlg
TFormStorage=TJvFormStorage
TFormStorageEditor=TJvFormStorageEditor
TGIFFrame=TJvGIFFrame
TGIFImage=TJvGIFImage
TGIFItem=TGIFItem
TGlyphCache=TJvGlyphCache
TGlyphList=TJvGlyphList
TGradCaptionsEditor=TGradCaptionsEditor
TGradientCaptionEditor=TGradientCaptionEditor
TGradientCaptionsProperty=TGradientCaptionsProperty
TGraphicPropertyEditor=TJvGraphicPropertyEditor
TGraphicsEditor=TJvGraphicsEditor
THack=TJvHack
THackBitmap=TJvHackBitmap
THackComponent=TJvHackComponent
THackDataSet=THackDataSet
THackFont=THackFont
THackLink=THackLink
THintProperty=THintProperty
THugeList=TJvHugeList
TIconFrame=TJvIconFrame
TIconList=TJvIconList
TIconListDialog=TIconListDialog
TIconListProperty=TIconListProperty
TIndexList=TJvIndexList
TIniLink=TjvIniLink
TKeyDataLink=TJvKeyDataLink
TLangDrivList=TJvLangDrivList
TLocateObject=TJvLocateObject
TLocCalculator=TJvLocCalculator
TLocCalendar=TJvLocCalendar
TLoginNameFieldProperty=TLoginNameFieldProperty
TLookupSourceLink=TLookupSourceLink
TMacro=TJvMacro
TMacros=TjvMacros
TMemBlobStream=TJvMemBlobStream
TMemDataSetEditor=TJvMemDataSetEditor
TMemoryDataEditor=TJvMemoryDataEditor
TMemoryRecord=TjvMemoryRecord
TMemoryTable=TJvMemoryTable
TMemoryTableEditor=TJvMemoryTableEditor
TMergeManager=TJvMergeManager
TMinMaxInfoEditDialog=TMinMaxInfoEditDialog
TMinMaxProperty=TMinMaxProperty
TMRUManager=TJvMRUManager
TNastyDataSet=TJvNastyDataSet
TNastyForm=TJvNastyForm
TNotifyThread=TjvNotifyThread
TObjectStrings=TJvObjectStrings
TOEMConversion=TJvOEMConversion
TOleController=TJvOleController
TOwnerDrawComboBox=TJvOwnerDrawComboBox
TPageBtnProperty=TJvPageBtnProperty
TPageHistory=TjvPageHistory
TPageHistoryItem=TJvPageHistoryItem
TPageManager=TJvPageManager
TPageManagerEditor=TJvPageManagerEditor
TPageNameProperty=TJvPageNameProperty
TPageProxy=TJvPageProxy
TPaintBoxEditor=TJvPaintBoxEditor
TPaletteGrid=TJvPaletteGrid
TParentControl=TJvParentControl
TPicClip=TJvPicClip
TPictEditor=TJvPictEditor
TPictProperty=TJvPictProperty
TPictureEditDialog=TJvPictureEditDialog
TPopupCalculator=TJvPopupCalculator
TPopupCalendar=TJvPopupCalendar
TPopupDataWindow=TJvPopupDataWindow
TPopupList=TJvPopupList
TPopupListbox=TJvPopupListbox
TPopupWindow=TJvPopupWindow
TProgressControlProperty=TJvProgressControlProperty
TProgressList=TJvProgressList
TPropInfoList=TJvPropInfoList
TPropsStorage=TJvPropsStorage
TProxyEditor=TJvProxyEditor
TProxyListProperty=TJvProxyListProperty
TQBEQuery=TJvQBEQuery
TQueryParamsDialog=TJvQueryParamsDialog
TRecentStrings=TJvRecentStrings
TRichEditStrings=TJvRichEditStrings
TRxBdeErrorDlg=TJvBdeErrorDlg
TRxButtonGlyph=TJvButtonGlyph
TRxCalcEdit=TJvCalcEdit
TRxCalculator=TJvCalculator
TRxCalculatorForm=TJvCalculatorForm
TRxCalendar=TJvCalendar
TRxCaption=TjvCaption
TRxCaptionList=TJvCaptionList
TRxCheckListBox=TJvxCheckListBox
TRxClock=TJvClock
TRxColorProperty=TJvColorProperty
TRxCustomCalcEdit=TJvCustomCalcEdit
TRxCustomLabel=TJvCustomLabel
TRxCustomListBox=TJvxCustomListBox
TRxCustomLogin=TJvCustomLogin
TRxCustomRichEdit=TJvCustomRichEdit
TRxCustomSlider=TJvCustomSlider
TRxCustomTrackBar=TJvCustomTrackBar
TRxDBCalcEdit=TJvDBCalcEdit
TRxDBComboEdit=TJvDBComboEdit
TRxDBFilter=TJvDBFilter
TRxDBGrid=TJvDBGrid
TRxDBLookupCombo=TJvDBLookupCombo
TRxDBLookupList=TJvDBLookupList
TRxDBRichEdit=TJvDBRichEdit
TRxDBStringProperty=TJvDBStringProperty
TRxDice=TjvDice
TRxDrawGrid=TJvDrawGrid
TRxDualListDialog=TJvDualListDialog
TRxDualListForm=TJvDualListForm
TRxErrorDialog=TJvErrorDialog
TRxFieldProperty=TJvFieldProperty
TRxFileOperator=TJvFileOperator
TRxFloatProperty=TJvFloatProperty
TRxFolderMonitor=TJvFolderMonitor
TRxGIFAnimator=TJvGIFAnimator
TRxGradient=TJvGradient
TRxGradientCaption=TJvGradientCaption
TRxHintWindow=TJvHintWindow
TRxImageControl=TJvImageControl
TRxImageListEditor=TJvImageListEditor
TRxIniFile=TJvIniFile
TRxInplaceEdit=TJvInplaceEdit
TRxInplaceEdit=TJvInplaceEdit
TRxIntegerProperty=TJvIntegerProperty
TRxLabel=TjvLabel
TRxListBoxStrings=TJvListBoxStrings
TRxLoginDialog=TJvLoginDialog
TRxLoginForm=TjvLoginForm
TRxLookupControl=TJvLookupControl
TRxLookupEdit=TJvLookupEdit
TRxMainMenu=TJvMainMenu
TRxMathParser=TJvMathParser
TRxMemoryData=TJvMemoryData
TRxModalResultProperty=TJvModalResultProperty
TRxParaAttributes=TJvParaAttributes
TRxParamsProperty=TJvParamsProperty
TRxPopupDataList=TJvPopupDataList
TRxPopupMenu=TJvPopupMenu
TRxQuery=TJvQuery
TRxQueryThread=TJvQueryThread
TRxRemoteLogin=TJvRemoteLogin
TRxRichEdit=TJvRichEdit
TRxSlider=TJvSlider
TRxSliderImages=TJvSliderImages
TRxSpeedButton=TJvSpeedButton
TRxSpinButton=TJvSpinButton
TRxSpinEdit=TJvSpinEdit
TRxSplitter=TJvSplitter
TRxSwitch=TJvSwitch
TRxTextAttributes=TJvTextAttributes
TRxTimer=TJvTimer
TRxTimerEvent=TJvTimerEvent
TRxTimerList=TJvTimerList
TRxTimerSpeedButton=TJvTimerSpeedButton
TRxTrayIcon=TJvTrayIcon
TRxUpDown=TJvUpDown
TRxWindowHook=TJvWindowHook
TScreenCanvas=TJvScreenCanvas
TSecretPanel=TJvSecretPanel
TSelectDataSetForm=TJvSelectDataSetForm
TSelectDateDlg=TJvSelectDateDlg
TServer=TJvServer
TSessionLink=TJvSessionLink
TSessionNameProperty=TJvSessionNameProperty
TSortCollection=TJvSortCollection
TSpeedBar=TJvSpeedBar
TSpeedbarButton=TJvSpeedBarButton
TSpeedbarCompEditor=TJvSpeedbarCompEditor
TSpeedbarEditor=TJvSpeedbarEditor
TSpeedbarSection=TjvSpeedbarSection
TSpeedbarSetupWindow=TJvSpeedbarSetupWindow
TSpeedItem=TjvSpeedItem
TSplashWindow=TJvSplashWindow
TSQLScript=TJvSQLScript
TStatusDataLink=TJvStatusDataLink
TStoredProcList=TJvStoredProcList
TStoredPropsProperty=TJvStoredPropsProperty
TStoredValue=TJvStoredValue
TStoredValues=TJvStoredValues
TStrEditDlg=TJvStrEditDlg
TStrHolder=TJvStrHolder
TStringsEditor=TJvStringsEditor
TTableItems=TJvTableItems
TTableList=TJvTableList
TTableNameProperty=TJvTableNameProperty
TTextListBox=TJvTextListBox
TTimerItemsEditor=TJvTimerItemsEditor
TTimersCollectionEditor=TJvTimersCollectionEditor
TTimersItemListProperty=TJvTimersItemListProperty
TTimerThread=TJvTimerThread
TUserTableNameProperty=TJvUserTableNameProperty
TVersionInfo=TJvVersionInfo
TWeekDayProperty=TJvWeekDayProperty
TWinControlCracker=TWinControlCracker
TWinMinMaxInfo=TJvWinMinMaxInfo
TDualListDialog=TJvDualListDialog
TRxDBComboBox=TJvDBComboBox
TTextListBox=TJvTextListBox
VerInfo=JvVerInf
StrUtils=JvStrUtils
RX_D3}=COMPILER3_UP}
RX_D4}=COMPILER4_UP}
USE_RX_GIF}=USE_Jv_GIF}
{$I RX.INC}={$I jvcl.inc}
TRxNumbering=TJvNumbering
CM_RXBUTTONPRESSED=CM_JVBUTTONPRESSED
RxErrorDialog=JvErrorDialog
RxErrorIntercept=JvErrorIntercept
