VER100=COMPILER3
VER130=COMPILER5
utf.inc=jvcl.inc
UTFAlarm=JvTFAlarm
TutfAlarm=JvTFAlarm
TAlarmInfo=TJvTFAlarmInfo
TAlarmList=TJvTFAlarmList
TutfAlarmEvent=TJvTFAlarmEvent
TutfAlarm=TJvTFAlarm
TutfComponent=TJvTFComponent
utfDays=JvTFDays
EutfDaysError=EJvTFDaysError
EBlockGranError=EJvTFBlockGranError
TutfDaysTimeBlocks=TJvTFDaysTimeBlocks
TutfDaysTimeBlock=TJvTFDaysTimeBlock
TutfDaysCoord=TJvTFDaysCoord
TDrawPicInfo=TJvTFDrawPicInfo
TutfDaysTemplates=TJvTFDaysTemplates
TListMoveEvent=TJvTFListMoveEvent
TCompNamesList=TJvTFCompNamesList
TutfDaysTemplate=TJvTFDaysTemplate
TutfDaysPrimeTime=TJvTFDaysPrimeTime
TCreateQuickEntryEvent= TJvTFCreateQuickEntryEvent
TDropApptEvent=TJvTFDropApptEvent
TDragRowColEvent=TJvTFDragRowColEvent
TSizeApptEvent=TJvTFSizeApptEvent
TSelectApptEvent=TJvTFSelectApptEvent
TDrawApptEvent=TJvTFDrawApptEvent
TDrawGrabHandleEvent=TJvTFDrawGrabHandleEvent
TDrawDataCellEvent=TJvTFDrawDataCellEvent
TutfDaysCorner=TJvTFDaysCorner
TDrawCornerEvent=TJvTFDrawCornerEvent
TDrawHdrEvent=TJvTFDrawHdrEvent
TDrawApptBarEvent=TJvTFDrawApptBarEvent
TFailEditorEvent=TJvTFFailEditorEvent
TDateChangingEvent=TJvTFDateChangingEvent
TGranChangingEvent=TJvTFGranChangingEvent
TShadeCellEvent=TJvTFShadeCellEvent
TBeginEditEvent=TJvTFBeginEditEvent
TInPlaceApptEditor=TJvTFInPlaceApptEditor
TApptMap=TJvTFApptMap
TVisibleScrollBars=TJvTFVisibleScrollBars
TutfDaysOption=TJvTFDaysOption
TutfDaysOptions=TJvTFDaysOptions
TutfDaysState=TJvTFDaysState
TColTitleStyle=TJvTFColTitleStyle
TutfDaysThresholds=TJvTFDaysThresholds
TutfDaysScrollBar=TJvTFDaysScrollBar
TUpdateTitleEvent=TJvTFUpdateTitleEvent
TUpdateTitlesEvent=TJvTFUpdateTitlesEvent
TutfDaysTimeBlock=TJvTFDaysTimeBlock
TutfDaysTimeBlocks=TJvTFDaysTimeBlocks
TutfDaysBlockProps=TJvTFDaysBlockProps
TutfDaysCol=TJvTFDaysCol
TutfDaysCols=TJvTFDaysCols
TRowHdrType=TJvTFRowHdrType
TutfDaysFancyRowHdrAttr=TJvTFDaysFancyRowHdrAttr
TutfDaysHdrAttr=TJvTFDaysHdrAttr
TTimeStampStyle=TJvTFTimeStampStyle
TutfDaysApptBar=TJvTFDaysApptBar
TutfDaysApptAttr=TJvTFDaysApptAttr
TSelCellStyle=TJvTFSelCellStyle
TSelCellAttr=TJvTFSelCellAttr
TGrabStyle=TJvTFGrabStyle
TutfDaysGrabHandles=TJvTFDaysGrabHandles
TutfDaysApptDrawInfo=TJvTFDaysApptDrawInfo
TGetutfDaysApptDrawInfoEvent=TJvTFGetDaysApptDrawInfoEvent
TutfDaysGrouping=TJvTFDaysGrouping
TAutoScrollDir=TJvTFAutoScrollDir
TutfDays=TJvTFDays
TutfDaysPrinterPageLayout=TJvTFDaysPrinterPageLayout
TutfDaysPageInfo=TJvTFDaysPageInfo
TutfDaysPrinter=TJvTFDaysPrinter
utfGantt=JvTFGantt
TutfVisibleScrollBars=TJvTFVisibleScrollBars
TutfGanttScrollBar=TJvTFGanttScrollBar
TutfGanttScale=TJvTFGanttScale
TutfGanttScaleFormat=TJvTFGanttScaleFormat
TutfGantt=TJvTFGantt
TGlanceCellsProperty=TJvTFGlanceCellsProperty
utfGlance=JvTFGlance
EutfGlanceError=EJvTFGlanceError
EGlanceViewerError
TUpdateTitleEvent=TJvTFUpdateTitleEvent
TCellPic=TJvTFCellPic
TCellPics=TJvTFCellPics
TSplitOrientation=TJvTFSplitOrientation
TGlanceCell=TJvTFGlanceCell
TGlanceCells=TJvTFGlanceCells
TutfFrameStyle=TJvTFFrameStyle
TutfFrameAttr=TJvTFFrameAttr
TGlanceFrameAttr=TJvTFGlanceFrameAttr
TutfTextAttr=TJvTFTextAttr
TGlanceTitlePicAttr=TJvTFGlanceTitlePicAttr
TTitleAlign=TJvTFTitleAlign
TutfGlanceTitleAttr=TJvTFGlanceTitleAttr
TGlanceCellAttr=TJvTFGlanceCellAttr
TGlanceTitle=TJvTFGlanceTitle
TGlanceMainTitle=TJvTFGlanceMainTitle
TGlanceCoord=TJvTFGlanceCoord
TutfGlanceSelOrder=TJvTFGlanceSelOrder
TGlanceSelList=TJvTFGlanceSelList
TGlanceDrawTitleEvent=TJvTFGlanceDrawTitleEvent
TGlanceDrawCellEvent=TJvTFGlanceDrawCellEvent
TGlanceDropApptEvent=TJvTFGlanceDropApptEvent
TUpdateCellTitleTextEvent=TJvTFUpdateCellTitleTextEvent
TutfCustomGlance=TJvTFCustomGlance
TGlanceViewer=TJvTFGlanceViewer
TutfGlance=TJvTFGlance
utfGlTxtVw=JvTFGlanceTextViewer
TGlTxtVwDrawInfo=TJvTFGlTxtVwDrawInfo
TGlTxtVwPointInfo=TJvTFGlTxtVwPointInfo
TGVTxtEditor=TJvTFGVTxtEditor
TGVTextControl=TJvTFGVTextControl
TLineDDClickEvent=TJvTFLineDDClickEvent
TTxtVwApptAttr=TJvTFTxtVwApptAttr
TGlTxtVwEditorAlign=TJvTFGlTxtVwEditorAlign
TGlanceTextViewer=TJvTFGlanceTextViewer
utfManager=JvTFManager
EutFScheduleManagerError=EJvTFScheduleManagerError
TutfServNotifyCode=TJvTFServNotifyCode
TutfSchedClass=TJvTFSchedClass
TutfApptClass=TJvTFApptClass
TutfHintClass=TJvTFHintClass
TCNRequestRefresh=TCNRequestRefresh
TDateList=TJvTFDateList
TutfNavEvent=TJvTFNavEvent
TutfControlEvent=TJvTFControlEvent
TSchedEvent=TJvTFSchedEvent
TApptEvent=TJvTFApptEvent
TVarApptEvent=TJvTFVarApptEvent
TFlushEvent=TJvTFFlushEvent
TPostApptQueryEvent=TJvTFPostApptQueryEvent
TCustomImageMap=TJvTFCustomImageMap
TStatePic=TJvTFStatePic
TStatePic=TJvTFStatePic
TTimeRange=TJvTFTimeRange
TutfAppt=TJvTFAppt
TutfSched=TJvTFSched
TutfScheduleManagerCacheType=TJvTFScheduleManagerCacheType
TutfScheduleManagerCache=TJvTFScheduleManagerCache
TSchedLoadMode=TJvTFSchedLoadMode
TLoadBatchEvent=TJvTFLoadBatchEvent
TGetApptDisplayTextEvent=TJvTFGetApptDisplayTextEvent
TApptDescEvent=TJvTFApptDescEvent
TutfScheduleManager=TJvTFScheduleManager
TutfHintProps=TJvTFHintProps
TutfHintType=TJvTFHintType
TShowutfHintEvent=TJvTFShowHintEvent
TutfHint=TJvTFHint
TDragInfo=TJvTFDragInfo
TutfComponent=TJvTFComponent
TutfControl=TJvTFControl
EutfPrinterError=EJvTFPrinterError
TMargins=TJvTFMargins
TPrinterMeasure=TJvTFPrinterMeasure
TutfPrinterState=TJvTFPrinterState
TutfPrinterDrawEvent=TJvTFPrinterDrawEvent
TProgressEvent=TJvTFProgressEvent
TutfPrinterPageLayout=TJvTFPrinterPageLayout
TutfPrinter=TJvTFPrinter
TutfUniversalPrinter=TJvTFUniversalPrinter
TDWNameSource=TJvTFDWNameSource
TDrawDWTitleEvent=TJvTFDrawDWTitleEvent
TutfDWNames=TJvTFDWNames
TutfNavigator=TJvTFNavigator
TGridLayoutCategory=TJvTFGridLayoutCategory
TCustomDrawCategory=TJvTFCustomDrawCategory
utfMonths=JvTFMonths
TMonthsScrollSize=TJvTFMonthsScrollSize
TutfMonths=TJvTFMonths
utfSprsMtrx=JvTFSparseMatrix
ESparseMatrixError=EJvTFSparseMatrixError
PSMQuantum=PSMQuantum
TSMQuantum=TSMQuantum
TSparseMatrix=TJvTFSparseMatrix
utfUtils=JvTFUtils
EDateError=EJvTFDateError
TVAlignment=TJvTFVAlignment
TDirection=TJvTFDirection
utfWeeks=JvTFWeeks
TutfDispOrder=TJvTFDispOrder
TutfWeeks=TJvTFWeeks
OnShowutfHint=OnShowHint
utfHintProps=HintProps
utfHint=Hint
utfControl=Control
utfPrinter=Printer
utfComp=Comp
TStateImageMap=TJvTFStateImageMap
TDayOfWeek = TTFDayOfWeek
TDaysOfWeek = TTFDaysOfWeek

